pid,lot_frontage,lot_area,mas_vnr_area,bsmtfin_sf_1,bsmtfin_sf_2,bsmt_unf_sf,total_bsmt_sf,1st_flr_sf,flr2nd_sf,low_qual_fin_sf,gr_liv_area,garage_area,wood_deck_sf,open_porch_sf,enclosed_porch,ssn3_porch,screen_porch,pool_area,misc_val
902301120,69.0,9142,0.0,0,0,1020,1020,908,1020,0,1928,440,0,60,112,0,0,0,0
905108090,69.0,9662,0.0,0,0,1967,1967,1967,0,0,1967,580,170,0,0,0,0,0,0
528218130,58.0,17104,0.0,554,0,100,654,664,832,0,1496,426,100,24,0,0,0,0,0
902207150,60.0,8520,0.0,0,0,968,968,968,0,0,968,480,0,0,184,0,0,0,0
535105100,60.0,9500,247.0,609,0,785,1394,1394,0,0,1394,514,0,76,0,0,185,0,0
923228370,21.0,1890,0.0,294,0,252,546,546,546,0,1092,286,0,0,64,0,0,0,0
902427150,52.0,8516,0.0,0,0,869,869,1093,0,0,1093,308,0,0,0,0,0,0,0
907202130,52.0,9286,0.0,196,0,1072,1268,1268,0,0,1268,252,173,0,0,0,0,0,0
533208090,39.0,3515,0.0,0,0,840,840,840,840,0,1680,588,0,111,0,0,0,0,0
914476010,75.0,10125,0.0,641,279,276,1196,1279,0,0,1279,473,238,83,0,0,0,0,0
531452100,50.0,7175,0.0,278,0,939,1217,1217,0,0,1217,484,0,64,0,0,0,0,0
903455140,60.0,7200,0.0,0,0,1040,1040,1040,0,0,1040,320,0,132,0,0,0,0,0
535303050,75.0,11310,0.0,0,0,1367,1367,1375,0,0,1375,451,0,30,0,0,0,0,0
906230030,75.0,7976,23.0,820,0,348,1168,1168,1619,0,2787,820,312,0,0,0,0,0,0
903206160,69.0,11737,0.0,0,0,848,848,1017,810,0,1827,240,27,36,42,0,0,0,0
905480180,60.0,9060,98.0,0,0,0,0,1340,0,0,1340,252,116,0,0,180,0,0,0
902128150,60.0,10800,0.0,590,0,294,884,884,552,0,1436,828,0,0,126,0,0,0,0
905451300,68.0,9571,0.0,257,0,816,1073,1073,0,0,1073,340,0,0,0,0,0,0,0
535425040,80.0,10800,104.0,913,0,400,1313,1773,0,0,1773,418,355,98,0,0,144,0,0
902330040,121.0,17671,0.0,216,0,700,916,916,826,0,1742,424,0,169,0,0,0,0,0
905105070,121.0,8246,0.0,188,668,204,1060,1060,0,0,1060,270,406,90,0,0,0,0,0
532354160,50.0,8499,0.0,660,0,204,864,864,0,0,864,732,0,312,0,0,0,0,0
531451020,50.0,8012,0.0,165,841,598,1604,1617,0,0,1617,533,0,69,0,0,0,0,0
906475050,50.0,21453,0.0,938,0,0,938,988,0,0,988,540,0,130,0,130,0,0,0
531363010,80.0,9605,0.0,0,0,1218,1218,1218,0,0,1218,576,0,178,0,0,0,0,0
907227050,60.0,7180,0.0,390,0,474,864,864,0,0,864,352,0,0,0,0,0,0,0
535150070,60.0,12513,0.0,0,0,715,715,1281,457,0,1738,368,55,0,0,0,0,0,0
902125020,50.0,9000,0.0,0,0,636,636,1089,661,0,1750,240,0,0,293,0,0,0,0
534425310,80.0,8800,156.0,763,0,173,936,1054,0,0,1054,480,120,0,0,0,0,0,0
534451020,51.0,3500,0.0,144,0,226,370,442,228,0,670,0,0,21,0,0,0,0,2000
527404150,51.0,7340,0.0,322,0,536,858,858,0,0,858,684,0,0,0,0,0,0,0
903458170,52.0,6240,0.0,152,0,628,780,848,0,360,1208,539,0,23,112,0,0,0,0
902326030,65.0,11700,0.0,0,0,1240,1240,1320,1320,0,2640,864,181,0,386,0,0,0,0
527378020,80.0,10000,0.0,1084,0,92,1176,1178,0,0,1178,439,224,0,0,0,0,0,0
907196060,75.0,11166,180.0,24,0,1468,1492,1492,0,0,1492,608,0,114,0,0,168,0,0
528218100,58.0,13204,44.0,0,0,608,608,608,850,0,1458,454,100,33,0,0,0,0,0
902103090,60.0,5520,0.0,284,0,863,1147,1147,510,0,1657,162,0,0,0,0,0,0,0
905228020,60.0,9000,0.0,0,0,0,0,998,0,0,998,460,0,0,140,0,0,0,0
535451010,74.0,8892,0.0,0,0,105,105,910,0,0,910,414,196,0,150,0,0,0,0
533242080,73.0,7321,0.0,0,0,1339,1339,1358,0,0,1358,625,176,174,0,0,0,0,0
533210010,40.0,3951,76.0,0,0,612,612,612,612,0,1224,528,0,234,0,0,0,0,0
528280100,40.0,11214,0.0,0,0,930,930,956,930,0,1886,431,89,0,0,0,0,0,0
534427140,75.0,7388,0.0,405,0,658,1063,1327,0,0,1327,624,0,0,0,0,0,0,0
535351050,75.0,14559,70.0,650,180,178,1008,1363,0,0,1363,288,324,42,0,0,168,0,2000
916226090,46.0,4054,352.0,949,0,552,1501,1501,0,0,1501,512,240,0,0,0,0,0,0
923228150,21.0,1533,0.0,0,0,546,546,798,546,0,1344,0,0,0,0,0,0,0,0
907196050,68.0,11250,162.0,486,0,434,920,920,866,0,1786,608,0,42,0,0,0,0,0
531479030,60.0,7800,0.0,641,0,187,828,965,0,0,965,300,421,0,0,0,0,0,0
535350040,74.0,5868,0.0,248,240,448,936,936,0,0,936,308,0,0,80,0,160,0,0
532377100,75.0,7500,0.0,824,0,216,1040,1040,0,0,1040,308,0,0,220,0,0,0,0
902427040,52.0,9439,0.0,324,0,588,912,912,336,0,1248,160,0,0,192,0,0,0,0
902329030,50.0,9000,0.0,0,0,346,346,1157,1111,0,2268,624,0,108,0,0,0,0,0
906380030,65.0,9345,156.0,0,0,1615,1615,1615,0,0,1615,864,168,30,0,0,0,0,0
903455090,60.0,7200,0.0,0,0,803,803,803,557,0,1360,297,0,65,190,0,0,0,0
903228070,60.0,6000,444.0,220,0,248,468,822,320,0,1142,320,0,0,98,0,0,0,0
527403040,61.0,7930,0.0,439,472,115,1026,1026,0,0,1026,440,171,48,0,0,0,0,0
903401020,60.0,9120,0.0,329,0,697,1026,1133,687,0,1820,240,0,100,0,0,0,0,0
534252040,60.0,9503,0.0,457,374,193,1024,1344,0,0,1344,484,316,28,0,0,0,0,0
527375210,85.0,11050,0.0,636,0,540,1176,1193,0,0,1193,506,40,0,0,0,0,0,0
907253060,85.0,10316,0.0,735,0,257,992,992,873,0,1865,839,0,184,0,0,0,0,0
528346050,136.0,11675,495.0,1660,0,322,1982,2006,0,0,2006,938,144,33,0,0,0,0,0
905200100,60.0,12900,0.0,1300,0,0,1300,1140,0,0,1140,400,0,0,190,0,0,0,0
905226170,85.0,13770,340.0,190,873,95,1158,1176,0,0,1176,303,0,0,0,0,0,0,0
534250335,85.0,13355,0.0,583,0,242,825,845,825,0,1670,464,0,0,0,0,0,0,0
531450040,65.0,7153,0.0,387,0,374,761,810,793,0,1603,484,0,124,0,0,0,0,0
528363050,65.0,10750,634.0,236,1526,262,2024,2063,0,0,2063,815,182,56,0,0,0,0,0
527403120,34.0,8125,0.0,614,0,244,858,858,0,0,858,0,0,0,0,0,0,0,0
528174030,34.0,3903,182.0,1030,0,272,1302,1302,0,0,1302,631,110,50,0,0,0,0,0
908226180,70.0,4270,0.0,544,0,0,544,774,0,0,774,0,0,0,286,0,0,0,0
907425015,70.0,4426,147.0,697,0,151,848,848,0,0,848,420,149,0,0,0,0,0,0
534451130,52.0,5825,108.0,0,0,600,600,747,0,0,747,528,0,0,32,0,0,0,0
528118060,59.0,23303,20.0,1230,0,278,1508,1508,1012,0,2520,640,192,273,0,0,0,0,0
909428180,59.0,25485,423.0,540,1020,0,1560,1560,0,0,1560,580,0,75,584,0,0,0,0
527165020,59.0,10784,76.0,0,0,384,384,802,670,0,1472,402,164,0,0,0,0,0,0
527404030,100.0,8510,178.0,500,0,543,1043,1050,0,0,1050,336,0,0,0,0,0,0,0
534129080,100.0,17871,359.0,528,0,1152,1680,1724,0,0,1724,480,0,0,0,0,0,0,0
923202060,100.0,21750,75.0,0,0,0,0,1771,0,0,1771,336,0,0,0,0,0,0,0
535402230,77.0,9510,161.0,701,0,434,1135,1207,0,0,1207,264,0,240,0,0,0,0,0
534276290,77.0,8339,0.0,0,0,0,0,882,0,0,882,294,0,0,0,0,0,0,1200
528150090,131.0,14828,674.0,1383,0,397,1780,1780,0,0,1780,816,144,68,0,0,0,0,0
907260040,70.0,8749,100.0,0,0,1459,1459,1459,0,0,1459,527,192,39,0,0,0,0,0
910205120,50.0,9140,0.0,308,0,321,629,727,380,0,1107,625,0,56,0,0,200,0,0
902305010,60.0,3600,0.0,316,0,371,687,687,671,0,1358,336,0,32,0,0,0,0,0
908102020,67.0,8777,0.0,173,337,166,676,760,676,0,1436,528,147,0,0,0,0,0,420
906476030,79.0,12798,0.0,462,0,154,616,616,1072,0,1688,603,403,114,185,0,0,0,400
528108020,98.0,12704,306.0,0,0,2042,2042,2042,0,0,2042,1390,0,90,0,0,0,0,0
907203070,68.0,7480,0.0,480,0,396,876,876,0,0,876,484,0,0,0,0,0,0,0
534251030,68.0,16500,509.0,962,0,270,1232,1320,0,0,1320,495,0,20,0,0,0,0,0
916326010,60.0,16669,653.0,0,0,1686,1686,1707,0,0,1707,511,574,64,0,0,0,0,0
535454160,60.0,8064,0.0,120,0,744,864,1064,0,431,1495,576,180,36,0,0,0,0,0
532354070,60.0,7758,0.0,588,0,411,999,999,0,0,999,264,0,132,0,0,0,0,0
908275090,70.0,11767,0.0,0,0,560,560,796,550,0,1346,384,168,24,0,0,0,0,0
902206130,50.0,6900,0.0,0,0,827,827,827,424,0,1251,240,0,0,0,0,0,0,0
527183030,40.0,4671,0.0,767,0,461,1228,1228,0,0,1228,472,168,120,0,0,0,0,0
903225040,50.0,6125,0.0,306,0,422,728,728,546,0,1274,224,0,0,192,0,0,0,0
902300040,53.0,9863,0.0,196,210,322,728,914,728,0,1642,374,0,0,0,0,0,0,0
905451330,68.0,9571,0.0,870,0,639,1509,1509,0,0,1509,322,158,0,0,0,576,0,0
528181070,34.0,4590,108.0,24,0,1530,1554,1554,0,0,1554,627,156,73,0,0,0,0,0
531385060,65.0,8450,0.0,472,0,355,827,827,850,0,1677,627,0,68,0,0,0,0,0
534177230,70.0,8400,0.0,643,0,167,810,810,855,0,1665,528,0,45,0,0,0,0,0
533252040,70.0,14694,450.0,1252,136,306,1694,1694,0,0,1694,642,501,120,0,225,0,0,0
535303030,95.0,14250,360.0,0,0,998,998,1790,0,0,1790,540,0,40,0,0,0,0,1500
923275090,37.0,6951,0.0,658,0,218,876,923,0,0,923,264,362,0,0,0,0,0,0
528164060,106.0,12720,680.0,2257,0,278,2535,2470,0,0,2470,789,154,65,0,0,216,144,0
535176070,90.0,11988,0.0,777,0,467,1244,1244,0,0,1244,336,0,40,0,0,0,0,0
902207010,40.0,3880,0.0,329,0,357,686,866,0,0,866,0,58,42,0,0,0,0,0
527163020,40.0,7685,112.0,518,0,179,697,697,804,0,1501,420,190,63,0,0,0,0,0
534152070,120.0,18837,0.0,687,46,491,1224,1287,604,0,1891,678,0,69,0,0,0,0,0
904100090,120.0,11136,0.0,0,0,1921,1921,1921,0,0,1921,576,0,180,0,0,0,0,0
905101300,72.0,10773,72.0,704,0,1128,1832,1832,0,0,1832,0,0,58,0,0,0,0,0
526351100,85.0,10200,440.0,844,0,590,1434,1434,0,0,1434,528,80,21,0,0,0,0,0
527366030,85.0,7500,0.0,0,0,1058,1058,1058,816,0,1874,588,0,134,0,0,0,0,0
902427180,76.0,11800,0.0,0,0,0,0,1382,0,0,1382,384,0,40,0,0,0,0,0
923205120,90.0,17217,0.0,0,0,1140,1140,1140,0,0,1140,0,36,56,0,0,0,0,0
531385130,90.0,16196,0.0,1443,0,39,1482,1494,0,0,1494,514,402,25,0,0,0,0,0
528320060,118.0,35760,1378.0,1387,0,543,1930,1831,1796,0,3627,807,361,76,0,0,0,0,0
903476030,76.0,7630,0.0,0,0,360,360,1032,780,0,1812,672,344,0,40,0,0,0,0
527451020,24.0,2016,304.0,0,0,630,630,630,672,0,1302,440,0,0,0,0,0,0,0
906340130,65.0,10816,364.0,1104,0,616,1720,1720,0,0,1720,846,208,104,0,0,0,0,0
527105030,78.0,9978,20.0,602,0,324,926,926,678,0,1604,470,360,36,0,0,0,0,0
528431040,98.0,12291,754.0,1572,0,394,1966,1966,0,0,1966,1092,76,52,0,0,0,0,0
528144030,86.0,11065,788.0,0,0,1085,1085,1120,850,0,1970,753,177,74,0,0,0,0,0
527252090,60.0,8147,230.0,1191,0,523,1714,1714,0,0,1714,517,156,55,0,0,0,0,0
527110080,60.0,13869,0.0,182,0,612,794,794,676,0,1470,388,0,75,0,0,0,0,0
909101190,60.0,6204,0.0,0,0,795,795,954,795,481,2230,440,0,188,0,0,0,0,0
528120130,102.0,12151,368.0,1249,0,165,1414,1414,917,0,2331,1003,192,63,0,0,0,0,0
907203010,120.0,9560,0.0,360,0,504,864,864,0,0,864,288,0,0,0,0,0,0,0
535305180,66.0,8923,0.0,643,0,365,1008,1008,0,0,1008,240,0,18,0,0,0,0,0
903230110,60.0,5520,0.0,68,0,497,565,565,651,0,1216,355,0,0,180,0,0,0,0
528458140,112.0,12606,120.0,0,0,1530,1530,1530,0,0,1530,984,212,136,0,0,0,0,0
907200190,59.0,8660,113.0,502,0,513,1015,1025,0,0,1025,370,127,0,0,0,0,0,0
527106150,59.0,9042,0.0,828,0,115,943,943,695,0,1638,472,100,38,0,0,0,0,0
905107250,86.0,11227,0.0,267,453,0,720,720,720,0,1440,480,192,38,0,0,0,0,0
535101020,75.0,11380,216.0,944,0,136,1080,1128,0,0,1128,315,238,0,0,0,0,0,1500
533213120,24.0,2280,216.0,550,0,194,744,757,792,0,1549,440,0,32,0,0,0,0,0
909281080,78.0,10452,371.0,426,252,850,1528,1225,908,0,2133,312,0,0,86,0,0,0,0
528427040,75.0,9910,0.0,0,0,1369,1369,1369,0,0,1369,605,0,203,0,0,0,0,0
531375040,63.0,13072,0.0,0,0,1114,1114,1114,0,0,1114,576,248,102,0,0,0,0,0
528174020,34.0,3901,182.0,866,0,436,1302,1302,0,0,1302,631,110,50,0,0,0,0,0
923276180,65.0,11625,0.0,596,0,220,816,816,0,0,816,264,330,0,0,0,0,0,0
534176060,78.0,9360,0.0,982,0,179,1161,1381,0,0,1381,676,0,0,0,0,0,0,0
534430080,68.0,9717,0.0,49,1029,0,1078,1078,0,0,1078,240,366,0,112,0,0,0,0
903484020,60.0,10320,0.0,0,0,756,756,756,713,0,1469,216,57,0,239,0,0,0,0
527226020,60.0,31220,0.0,0,0,1632,1632,1474,0,0,1474,495,0,0,144,0,0,0,750
908250040,57.0,8050,0.0,0,0,0,0,929,208,0,1137,0,0,0,0,0,0,0,0
902109140,60.0,7596,360.0,0,0,960,960,960,1000,0,1960,400,0,0,0,0,0,0,0
903427120,57.0,8094,0.0,0,0,1048,1048,1048,720,0,1768,576,0,0,150,0,0,0,0
907200290,57.0,10900,153.0,378,0,311,689,689,703,0,1392,299,0,36,0,0,0,0,450
911226030,60.0,9000,0.0,0,0,592,592,432,432,0,864,216,0,30,160,0,0,0,0
533254050,110.0,15417,0.0,121,0,1619,1740,1740,0,0,1740,540,228,20,218,0,0,0,0
907412010,89.0,11645,0.0,0,0,860,860,860,860,0,1720,565,0,70,0,0,0,0,0
905451390,70.0,10512,0.0,491,0,497,988,988,638,0,1626,332,366,0,0,0,0,0,0
903476110,60.0,5586,0.0,0,0,901,901,1088,110,0,1198,0,0,98,0,0,0,0,0
527452310,68.0,7838,0.0,769,0,95,864,900,0,0,900,288,175,144,0,0,0,0,0
535378020,52.0,9022,0.0,0,0,768,768,792,0,0,792,240,316,0,120,0,0,0,0
535150210,52.0,7390,151.0,902,0,196,1098,1098,0,0,1098,260,0,0,0,0,0,0,0
923228270,21.0,1900,0.0,0,0,546,546,546,546,0,1092,0,0,0,0,0,0,0,0
535151020,73.0,8760,0.0,873,0,63,936,936,0,0,936,315,0,0,0,219,0,0,0
906203140,103.0,13125,0.0,48,634,422,1104,912,1215,0,2127,833,72,192,224,0,0,0,0
907255020,103.0,9240,396.0,0,0,1055,1055,1055,1208,0,2263,905,0,45,0,0,189,0,0
907295020,75.0,13125,215.0,994,0,484,1478,1493,0,0,1493,508,140,39,0,0,0,0,0
908275130,70.0,11767,0.0,352,0,416,768,768,432,0,1200,240,0,0,0,0,0,0,0
535155110,80.0,9250,0.0,480,468,108,1056,1056,0,0,1056,260,390,0,0,0,0,0,0
528110020,105.0,13693,472.0,2288,0,342,2630,2674,0,0,2674,762,360,50,0,0,0,0,0
528180130,48.0,6472,500.0,0,0,1451,1451,1456,0,0,1456,539,192,42,0,0,0,0,0
528431060,78.0,10206,468.0,33,0,1530,1563,1563,0,0,1563,758,144,99,0,0,0,0,0
531375120,66.0,13695,0.0,814,0,300,1114,1114,0,0,1114,576,0,78,0,0,0,0,0
528228285,43.0,3203,14.0,16,0,1129,1145,1145,0,0,1145,437,100,116,0,0,0,0,0
527365010,75.0,9512,0.0,788,0,172,960,960,1358,0,2318,541,0,246,0,0,0,0,0
907412040,75.0,9750,50.0,24,0,1421,1445,1445,0,0,1445,470,0,35,0,0,0,0,0
528320050,160.0,15623,0.0,2096,0,300,2396,2411,2065,0,4476,813,171,78,0,0,0,555,0
907135170,60.0,8072,0.0,746,0,244,990,990,0,0,990,480,0,64,0,0,0,0,0
905427140,78.0,11679,96.0,612,1164,0,1776,1560,0,0,1560,528,453,253,144,0,0,0,0
533212120,24.0,2544,0.0,0,0,600,600,520,623,80,1223,480,0,166,0,0,0,0,0
527164120,24.0,10832,0.0,0,0,712,712,1086,809,0,1895,409,143,46,0,0,0,0,500
535402220,77.0,9786,0.0,600,0,312,912,1085,649,0,1734,440,0,0,0,0,128,0,0
535382150,60.0,5400,0.0,0,0,691,691,691,0,0,691,216,0,20,94,0,0,0,0
905108120,75.0,8235,99.0,483,0,1466,1949,1949,0,0,1949,586,32,0,0,0,0,0,0
923228310,21.0,1894,0.0,252,0,294,546,546,546,0,1092,286,0,24,0,0,0,0,0
535453180,70.0,7903,0.0,739,0,503,1242,1242,0,0,1242,324,0,0,0,0,0,0,0
909250030,51.0,9839,0.0,0,0,894,894,894,772,0,1666,0,0,156,0,0,0,0,0
534252270,51.0,9900,342.0,552,0,280,832,1098,880,0,1978,486,0,43,0,0,0,0,0
532477040,75.0,17542,0.0,125,1031,36,1192,1516,651,0,2167,518,220,47,0,0,0,0,0
528222020,75.0,9073,0.0,0,0,738,738,738,754,0,1492,440,100,32,0,0,0,0,0
527376100,78.0,10140,174.0,0,0,1064,1064,1350,0,0,1350,478,0,0,0,0,0,0,0
905480030,60.0,9060,0.0,204,0,356,560,698,560,0,1258,280,0,0,0,0,0,0,0
528250020,60.0,8965,0.0,652,0,130,782,806,683,0,1489,400,0,75,0,0,0,0,0
903206120,63.0,7793,0.0,474,0,634,1108,1160,908,0,2068,315,0,0,60,0,0,0,0
532353020,63.0,9750,0.0,68,884,28,980,980,0,0,980,400,0,28,0,0,0,0,0
908250030,74.0,10206,0.0,0,0,0,0,944,0,0,944,528,0,0,0,0,0,0,0
527376110,78.0,10140,0.0,194,0,638,832,832,832,0,1664,528,0,28,0,0,259,0,0
923225390,31.0,2394,0.0,915,0,30,945,945,0,0,945,253,174,0,56,0,108,0,0
903425420,55.0,10267,0.0,210,606,0,816,838,0,0,838,275,0,0,112,0,0,0,0
532377020,60.0,6360,0.0,489,0,375,864,864,0,0,864,276,0,0,0,0,0,0,650
528218050,65.0,10237,0.0,0,0,783,783,783,701,0,1484,393,0,72,0,0,0,0,0
914452120,65.0,7540,0.0,773,0,115,888,912,0,0,912,470,0,0,0,0,192,0,0
528435020,80.0,9428,310.0,729,0,226,955,955,919,0,1874,880,168,108,0,0,0,0,0
909256010,84.0,10164,0.0,646,0,346,992,992,473,0,1465,240,0,126,0,0,0,0,0
905225040,85.0,13825,0.0,0,0,533,533,1021,580,0,1601,300,280,34,0,0,0,0,0
535325130,55.0,7700,0.0,271,0,30,301,1145,0,0,1145,684,0,0,0,0,0,0,0
528344070,60.0,17433,114.0,0,0,1629,1629,1645,830,0,2475,962,23,172,0,0,256,0,0
902325100,70.0,6300,0.0,0,0,1226,1226,1226,878,0,2104,432,0,341,88,0,0,0,0
905103180,80.0,10366,0.0,456,0,456,912,934,0,0,934,336,77,0,0,0,0,0,500
531450170,76.0,9291,120.0,426,0,406,832,832,878,0,1710,506,144,70,0,0,0,0,0
903475100,76.0,5775,0.0,0,0,483,483,741,686,0,1427,379,0,24,112,0,0,0,0
535451210,60.0,7200,0.0,0,0,0,0,1040,0,0,1040,420,0,29,0,0,0,0,0
527455100,24.0,2179,0.0,70,0,785,855,855,601,0,1456,460,0,28,0,0,0,0,0
905452120,50.0,9360,216.0,324,0,297,621,621,648,0,1269,280,0,236,0,0,0,0,0
528181080,44.0,6442,178.0,24,0,1346,1370,1370,0,0,1370,484,120,49,0,0,0,0,0
528427070,86.0,14598,74.0,0,0,894,894,894,1039,0,1933,668,100,18,0,0,0,0,0
527161090,86.0,8637,0.0,871,0,52,923,947,767,0,1714,451,256,48,0,0,0,0,0
534250410,76.0,9120,270.0,442,0,459,901,943,933,0,1876,540,0,69,0,0,0,0,0
909100150,67.0,5142,0.0,224,0,725,949,949,343,0,1292,205,0,0,183,0,0,0,0
916176125,150.0,215245,0.0,1236,820,80,2136,2036,0,0,2036,513,0,0,0,0,0,0,0
533215070,35.0,4109,260.0,1141,0,416,1557,1557,0,0,1557,484,124,113,0,0,0,0,0
531450030,75.0,8285,0.0,397,0,439,836,844,893,0,1737,506,192,85,0,0,0,0,0
905202190,75.0,20355,123.0,810,826,229,1865,1830,0,0,1830,521,0,115,168,0,0,0,0
902110080,60.0,3378,0.0,0,0,651,651,707,682,0,1389,240,0,0,126,0,0,0,0
903481130,86.0,5160,0.0,749,63,46,858,892,0,0,892,0,0,0,105,0,160,0,0
535453080,86.0,7500,0.0,574,0,466,1040,1040,0,0,1040,286,0,0,0,0,0,0,0
533223010,35.0,3735,218.0,450,0,241,691,713,739,0,1452,506,0,34,0,0,0,0,0
535377090,64.0,6979,0.0,1056,0,0,1056,1056,0,0,1056,576,264,56,0,0,0,0,600
535475020,71.0,7056,415.0,400,0,380,780,983,813,0,1796,483,0,50,0,0,0,0,0
528221070,122.0,11911,0.0,0,0,684,684,684,876,0,1560,400,100,38,0,0,0,0,0
909176150,122.0,7890,0.0,238,0,618,856,856,0,0,856,399,0,0,0,0,166,0,0
535383110,60.0,10800,0.0,0,0,720,720,846,0,0,846,576,0,0,0,0,0,0,0
907260010,60.0,11250,0.0,0,0,1128,1128,1149,1141,0,2290,779,0,0,0,0,0,0,0
528445020,70.0,9605,0.0,0,0,982,982,982,995,0,1977,574,240,53,0,0,0,0,0
909277090,80.0,14680,0.0,793,0,480,1273,1273,0,0,1273,307,483,0,0,0,115,0,0
528354050,79.0,10208,921.0,0,0,1264,1264,1277,1067,0,2344,889,220,0,0,0,0,0,0
905426030,85.0,19550,0.0,1035,0,545,1580,1518,0,0,1518,0,0,39,0,0,0,0,0
923226320,21.0,1491,0.0,150,480,0,630,630,0,0,630,0,96,24,0,0,0,0,0
902102100,60.0,4800,771.0,48,0,661,709,1157,687,0,1844,240,84,0,0,0,0,0,0
908275200,60.0,8172,0.0,544,0,224,768,768,0,0,768,355,0,0,196,0,0,0,0
535150300,174.0,25419,0.0,1036,184,140,1360,1360,1360,392,3112,795,0,16,552,0,0,512,0
527107030,174.0,13031,0.0,592,0,99,691,691,807,0,1498,409,315,44,0,0,0,0,0
902111010,50.0,5633,0.0,0,0,844,844,844,0,0,844,216,50,81,123,0,0,0,0
528102140,110.0,14257,726.0,1360,0,416,1776,1794,978,0,2772,754,135,64,0,0,0,0,0
528429120,49.0,20896,0.0,1721,0,356,2077,2097,0,0,2097,1134,192,267,0,0,0,0,0
533208010,47.0,4230,0.0,0,0,1352,1352,1352,0,0,1352,466,0,241,0,0,0,0,0
907290260,120.0,15611,0.0,0,0,1079,1079,1079,840,0,1919,685,0,51,0,0,0,0,0
527301280,120.0,10960,0.0,256,0,1028,1284,1284,0,0,1284,480,0,0,192,0,0,0,0
528168040,93.0,11999,340.0,0,0,1181,1181,1234,1140,0,2374,656,104,100,0,0,0,0,0
908178050,90.0,11060,0.0,0,0,1150,1150,1164,1150,0,2314,502,0,274,0,0,0,0,0
921128020,89.0,13214,0.0,0,0,2002,2002,2018,0,0,2018,746,144,76,0,0,0,0,0
906380040,66.0,10235,306.0,0,0,1643,1643,1651,0,0,1651,870,192,64,0,0,0,0,0
526302110,74.0,13008,0.0,564,0,318,882,882,0,0,882,502,0,0,0,0,0,0,0
534275060,60.0,7436,0.0,734,0,160,894,894,0,0,894,396,0,0,0,360,0,0,0
528290120,60.0,8123,16.0,0,0,982,982,1007,793,0,1800,463,100,63,0,0,0,0,0
528186120,68.0,7820,362.0,0,0,1869,1869,1869,0,0,1869,617,210,54,0,0,0,0,0
911370450,59.0,5568,473.0,1573,0,0,1573,1625,0,0,1625,495,123,0,0,0,153,0,0
909175030,60.0,8400,0.0,388,0,552,940,1192,403,0,1595,240,0,0,108,0,0,0,0
906223210,80.0,9828,0.0,584,0,544,1128,1142,878,0,2020,466,0,155,0,0,0,0,0
528482130,75.0,9375,0.0,0,0,912,912,912,1182,0,2094,615,182,182,0,0,0,0,0
916403010,130.0,11457,0.0,1005,0,387,1392,1412,0,0,1412,576,0,0,169,0,0,0,0
903231220,51.0,6120,0.0,347,0,381,728,728,434,0,1162,258,0,24,0,0,0,0,0
902104060,55.0,8800,0.0,0,0,576,576,792,348,0,1140,0,0,160,0,0,0,0,0
528170040,56.0,20431,870.0,1410,0,438,1848,1848,880,0,2728,706,0,0,0,0,0,0,0
906223080,85.0,10560,0.0,474,0,605,1079,1079,800,0,1879,473,400,100,144,0,0,0,0
916326090,149.0,19958,1224.0,0,0,585,585,2279,0,0,2279,461,274,0,0,0,138,0,0
528235000,87.0,11084,0.0,192,0,192,384,744,630,0,1374,400,100,0,0,0,0,0,0
903453050,60.0,10266,0.0,372,0,396,768,768,768,0,1536,308,0,216,80,0,0,0,0
527450150,21.0,1890,285.0,356,0,316,672,672,546,0,1218,264,144,28,0,0,0,0,0
905403150,85.0,10452,216.0,500,0,594,1094,1094,0,0,1094,495,0,0,0,0,287,0,0
527108090,168.0,23257,0.0,0,0,868,868,887,1134,0,2021,422,0,100,0,0,0,0,0
535475010,76.0,7570,420.0,0,0,780,780,993,813,0,1806,483,0,55,0,0,0,0,0
535152250,70.0,8400,0.0,922,0,392,1314,1314,0,0,1314,294,250,0,0,0,0,0,0
906223060,75.0,9317,137.0,513,0,227,740,1006,769,0,1775,425,234,72,192,0,0,0,0
534403100,82.0,9020,259.0,624,336,288,1248,1350,0,0,1350,520,176,0,0,0,0,0,0
908186090,35.0,3675,82.0,547,0,0,547,1072,0,0,1072,525,0,44,0,0,0,0,0
902332030,60.0,7200,0.0,1046,0,168,1214,1260,1031,0,2291,506,0,0,0,0,99,0,0
528480150,65.0,8125,0.0,0,0,770,770,778,798,0,1576,614,0,50,0,0,0,0,0
902329090,60.0,7200,0.0,0,0,596,596,998,764,0,1762,576,36,0,221,0,0,0,0
909282030,60.0,14100,632.0,192,0,536,728,1968,1479,0,3447,1014,314,12,0,0,0,0,0
527405130,60.0,7038,0.0,726,0,138,864,864,0,0,864,576,210,0,0,0,0,0,0
908127050,73.0,16133,0.0,847,0,329,1176,1176,0,0,1176,360,0,92,0,0,112,0,0
907290140,36.0,4435,170.0,659,0,189,848,848,0,0,848,420,140,0,0,0,0,0,0
533251130,36.0,16157,0.0,680,391,289,1360,1432,0,0,1432,588,168,180,0,0,0,0,0
535451230,60.0,7200,0.0,0,0,0,0,1048,0,0,1048,420,0,27,0,0,0,0,0
535150240,75.0,9000,0.0,812,0,124,936,1128,0,0,1128,286,0,0,0,0,0,0,0
527108040,72.0,10463,0.0,0,0,893,893,901,900,0,1801,800,0,116,0,0,0,0,0
909131170,72.0,12155,0.0,156,0,516,672,810,672,0,1482,400,0,0,254,0,0,0,0
923400150,63.0,10712,0.0,212,0,762,974,974,0,0,974,0,0,28,0,0,0,0,0
902301150,69.0,9143,0.0,0,0,346,346,709,308,0,1017,308,0,0,139,0,0,0,0
903228080,60.0,6000,0.0,375,0,360,735,869,349,0,1218,440,0,0,0,0,0,0,0
528390210,60.0,29959,0.0,595,0,378,973,979,871,0,1850,467,168,98,0,0,0,0,0
909281010,80.0,16560,0.0,503,0,449,952,1170,1175,0,2345,360,0,0,0,0,0,0,0
527450210,21.0,1953,408.0,309,0,174,483,483,504,0,987,264,72,0,0,0,0,0,0
531479020,60.0,9000,0.0,0,0,784,784,784,0,0,784,360,0,0,91,0,0,0,0
905451320,68.0,9571,0.0,739,0,405,1144,1144,0,0,1144,596,44,0,0,0,0,0,0
535402180,75.0,8700,53.0,192,0,728,920,888,0,0,888,240,0,0,0,0,0,0,0
532351150,68.0,8927,0.0,0,0,0,0,1286,368,0,1654,528,0,0,0,0,0,0,0
923228390,21.0,1890,0.0,0,0,546,546,546,546,0,1092,286,0,0,0,0,0,0,0
535457050,70.0,7000,0.0,0,0,0,0,925,0,0,925,300,0,0,0,0,0,0,0
905201090,70.0,14175,0.0,988,0,200,1188,1437,0,0,1437,576,304,0,0,0,0,0,0
907425010,78.0,4426,147.0,697,0,151,848,848,0,0,848,420,149,0,0,0,0,0,0
906394060,78.0,9316,532.0,0,0,784,784,784,812,0,1596,610,144,45,0,0,0,0,0
528385050,79.0,9085,286.0,816,0,254,1070,1094,967,0,2061,647,296,102,209,0,0,0,0
916455120,82.0,11202,206.0,1029,0,403,1432,1440,0,0,1440,467,185,95,0,0,0,0,0
909275040,82.0,9650,0.0,0,0,784,784,819,784,0,1603,599,0,217,0,0,0,0,0
909275020,82.0,7136,423.0,484,0,495,979,979,979,0,1958,492,0,0,0,0,0,0,0
528180120,44.0,7390,308.0,800,0,1084,1884,1884,0,0,1884,649,231,90,0,0,0,0,0
532353130,71.0,7064,153.0,560,0,420,980,980,0,0,980,484,192,0,0,0,0,0,0
903234090,51.0,6120,0.0,203,0,897,1100,1226,676,0,1902,576,0,139,55,0,0,0,0
902105130,60.0,4800,0.0,0,0,672,672,672,0,0,672,256,0,0,0,0,0,0,0
905200160,60.0,9000,0.0,288,0,718,1006,1006,0,0,1006,0,0,24,0,0,0,0,0
916125425,64.0,164660,0.0,1249,147,103,1499,1619,167,0,1786,529,670,0,0,0,0,0,700
906380180,64.0,6762,0.0,0,0,1286,1286,1294,0,0,1294,662,168,55,0,0,0,0,0
904301100,64.0,10547,0.0,1152,0,0,1152,1152,0,0,1152,252,0,0,0,0,0,0,0
532378050,78.0,13052,0.0,712,0,312,1024,1024,0,0,1024,308,0,0,0,0,0,0,0
909426060,78.0,15600,405.0,760,0,408,1168,1278,1037,0,2315,342,0,0,0,0,192,0,0
527127150,41.0,4920,0.0,616,0,722,1338,1338,0,0,1338,582,0,0,170,0,0,0,0
528429070,74.0,13253,128.0,1096,0,482,1578,1578,0,0,1578,642,0,26,0,0,0,0,0
528222010,96.0,11631,236.0,0,0,1052,1052,1052,1321,0,2373,632,120,46,0,0,0,0,0
909177100,60.0,7200,0.0,0,0,0,0,862,1788,0,2650,0,0,0,0,0,0,0,500
527258010,88.0,11394,350.0,1445,0,411,1856,1856,0,0,1856,834,113,0,0,0,0,0,0
528120060,83.0,10159,450.0,1646,0,284,1930,1940,0,0,1940,606,168,95,0,0,0,0,0
527131110,45.0,6264,0.0,656,0,1008,1664,1682,0,0,1682,528,0,0,0,0,0,0,0
528294070,66.0,8738,302.0,0,0,975,975,1005,1286,0,2291,429,192,0,0,0,0,0,0
534451110,66.0,7015,161.0,185,0,524,709,979,224,0,1203,352,0,0,248,0,0,0,0
903232170,52.0,6240,0.0,0,0,0,0,672,240,0,912,0,0,0,0,0,0,0,0
905476120,50.0,8405,0.0,241,391,229,861,961,406,0,1367,384,0,130,112,0,0,0,0
909176140,50.0,5000,0.0,218,0,808,1026,1026,665,0,1691,308,0,0,242,0,0,0,0
528120090,94.0,12883,256.0,0,0,1544,1544,1544,0,0,1544,868,0,35,0,0,0,0,0
907227080,60.0,7200,0.0,777,0,117,894,894,0,0,894,600,215,0,0,0,0,0,0
527452060,60.0,4928,0.0,958,0,0,958,958,0,0,958,440,0,60,0,0,0,0,0
535403280,64.0,8712,0.0,860,0,132,992,1306,0,0,1306,756,0,0,0,0,0,0,0
528228550,43.0,3010,14.0,16,0,1126,1142,1142,0,0,1142,440,90,0,0,0,0,0,0
903456110,60.0,9780,0.0,354,398,224,976,976,976,0,1952,299,285,0,0,0,216,0,0
534479240,79.0,9462,0.0,0,0,704,704,1024,704,0,1728,234,245,60,0,0,0,0,0
535302120,76.0,9482,657.0,0,0,1866,1866,1866,0,0,1866,495,0,0,0,0,0,0,0
527165010,76.0,14067,194.0,504,0,332,836,851,858,0,1709,416,0,40,0,0,0,0,0
534478140,95.0,11345,567.0,220,0,708,928,928,992,0,1920,400,0,0,0,0,0,0,0
533253030,95.0,3760,0.0,1009,182,44,1235,1235,0,0,1235,484,133,78,0,0,0,0,0
903481010,60.0,10320,0.0,0,0,451,451,759,0,0,759,576,40,0,0,0,0,0,0
909254070,54.0,7588,0.0,352,0,441,793,901,901,0,1802,216,0,0,40,0,0,0,0
902207170,60.0,8520,0.0,0,0,624,624,792,0,0,792,287,0,0,81,0,0,0,0
535353160,60.0,14190,0.0,0,0,925,925,1000,544,0,1544,0,231,0,0,0,0,0,0
535450220,60.0,11664,206.0,336,0,746,1082,1082,0,0,1082,240,0,130,0,0,0,0,0
533253060,30.0,4420,0.0,728,0,0,728,788,0,0,788,484,133,42,0,0,0,0,0
923229140,61.0,33983,0.0,1112,0,48,1160,1676,0,0,1676,672,690,90,0,0,0,0,0
902134120,56.0,10134,0.0,0,0,801,801,801,646,0,1447,0,80,0,244,0,0,0,0
535450070,60.0,12144,0.0,375,0,457,832,1036,0,232,1268,288,0,28,0,0,0,0,0
907185060,70.0,8750,116.0,505,0,299,804,804,878,0,1682,523,0,77,0,0,0,0,0
533130160,88.0,11134,180.0,1129,0,261,1390,1402,823,0,2225,713,198,30,0,0,0,0,0
533244030,68.0,7379,0.0,484,0,491,975,975,873,0,1848,592,280,184,0,0,0,0,0
527107120,54.0,9783,0.0,0,0,821,821,821,955,0,1776,443,286,116,0,0,0,0,0
527455270,54.0,9477,65.0,340,0,524,864,892,0,0,892,264,0,0,0,0,0,0,0
528290010,60.0,15384,0.0,724,0,64,788,788,702,0,1490,388,100,75,0,0,0,0,0
905103130,60.0,11327,305.0,779,0,285,1064,1064,0,0,1064,528,314,48,0,0,0,0,0
903476090,41.0,5852,188.0,169,0,851,1020,978,886,0,1864,0,0,188,102,0,0,0,0
908152110,72.0,7200,0.0,288,0,396,684,684,714,0,1398,440,0,0,0,0,0,0,0
527451380,21.0,1680,281.0,317,0,355,672,672,546,0,1218,264,0,28,0,0,0,0,0
528429130,85.0,10182,420.0,1220,0,440,1660,1660,0,0,1660,500,322,50,0,0,0,0,0
905402110,75.0,9375,0.0,799,0,168,967,1350,0,0,1350,504,237,0,0,0,0,0,0
535425010,96.0,11275,300.0,0,0,710,710,1898,1080,0,2978,564,240,0,0,0,0,0,0
902406070,60.0,9720,0.0,0,0,741,741,780,741,0,1521,640,0,0,238,0,0,0,0
907181100,68.0,9017,0.0,560,0,871,1431,1431,0,0,1431,666,0,35,0,0,0,0,0
914465020,75.0,10125,0.0,445,250,412,1107,1040,1012,0,2052,642,210,91,0,0,0,0,0
910200040,85.0,8500,0.0,0,0,793,793,997,520,0,1517,0,0,0,144,0,0,0,0
534479130,79.0,9490,0.0,403,165,238,806,958,620,0,1578,240,0,0,32,0,0,0,0
923251160,124.0,27697,198.0,811,0,585,1396,1608,0,0,1608,444,152,38,0,0,0,0,0
904300150,72.0,10632,0.0,0,0,689,689,725,499,0,1224,180,0,0,248,0,0,0,0
534278230,85.0,11475,95.0,0,0,1584,1584,1776,0,0,1776,888,0,25,0,0,0,0,0
907412090,85.0,11049,0.0,0,0,1234,1234,1234,0,0,1234,484,0,30,0,0,0,0,0
911370460,44.0,4750,481.0,1573,0,0,1573,1625,0,0,1625,538,123,0,0,0,153,0,0
917425190,50.0,35133,226.0,1159,0,413,1572,1572,0,0,1572,995,0,263,0,0,263,0,0
909425180,80.0,12984,459.0,1283,147,0,1430,1647,0,0,1647,621,0,0,0,0,0,0,0
916460110,75.0,9157,0.0,0,0,912,912,1072,942,0,2014,486,124,114,0,0,0,0,0
902207080,49.0,5820,0.0,256,0,906,1162,1163,0,0,1163,220,142,98,0,0,0,0,0
535402010,81.0,9671,480.0,0,0,1248,1248,1248,1296,0,2544,907,0,0,0,0,0,0,0
527450520,21.0,1890,422.0,483,0,0,483,483,504,0,987,352,411,0,0,0,0,0,0
903400040,60.0,13515,0.0,0,0,764,764,1060,764,0,1824,520,0,0,126,0,0,0,0
528327010,60.0,9233,877.0,1182,0,358,1540,1540,1315,0,2855,774,247,55,0,0,0,0,0
905104030,70.0,8400,0.0,187,627,0,814,913,0,0,913,240,0,0,252,0,0,0,0
921126010,93.0,15306,100.0,80,0,1652,1732,1776,0,0,1776,712,0,0,0,0,0,0,0
909254090,55.0,7642,0.0,0,0,912,912,912,514,0,1426,216,0,240,0,0,0,0,0
911370540,44.0,3842,174.0,1373,0,221,1594,1646,0,0,1646,482,128,53,0,0,155,0,0
528253010,34.0,5063,166.0,904,0,410,1314,1314,0,0,1314,626,172,62,0,0,0,0,0
905476230,42.0,4235,149.0,552,393,104,1049,1049,0,0,1049,266,0,105,0,0,0,0,0
909252110,63.0,15576,0.0,0,0,840,840,840,840,0,1680,308,0,0,160,0,0,0,0
903475060,60.0,10120,0.0,0,0,925,925,964,925,0,1889,308,0,0,264,0,0,0,0
528138010,102.0,13514,285.0,1142,0,632,1774,1808,0,0,1808,850,200,26,0,0,0,0,0
528106060,110.0,13440,190.0,0,0,1108,1108,1148,1402,0,2550,670,120,39,0,0,0,0,0
907285080,70.0,8750,0.0,642,0,273,915,933,975,0,1908,493,144,133,0,0,0,0,0
906475100,70.0,11500,0.0,262,723,197,1182,1643,0,0,1643,438,339,0,0,0,0,0,0
535382020,60.0,10800,0.0,664,0,290,954,1766,648,0,2414,520,142,0,0,0,0,0,0
909254050,54.0,7609,0.0,406,0,392,798,798,714,0,1512,180,85,16,41,0,0,0,0
923251080,54.0,26142,189.0,593,0,595,1188,1188,0,0,1188,312,261,39,0,0,0,0,0
902103150,57.0,9184,0.0,0,0,780,780,948,375,0,1323,400,0,0,0,0,0,0,0
527451330,21.0,1680,492.0,300,0,225,525,525,567,0,1092,320,0,0,0,0,0,0,0
528435040,79.0,9416,205.0,1126,0,600,1726,1726,0,0,1726,786,171,138,0,0,266,0,0
531453040,70.0,8400,130.0,0,0,650,650,888,676,0,1564,476,0,50,0,0,204,0,0
535450100,60.0,12144,0.0,455,0,455,910,910,611,0,1521,597,199,0,168,0,0,0,0
906385010,94.0,10402,0.0,0,0,1226,1226,1226,0,0,1226,740,0,36,0,0,0,0,0
902331010,94.0,3300,0.0,0,0,624,624,816,0,0,816,0,0,33,0,0,0,0,0
907420050,64.0,8334,0.0,0,0,1330,1330,1330,0,0,1330,437,0,23,0,0,0,0,0
527107240,70.0,11207,0.0,714,0,88,802,802,709,0,1511,413,95,75,0,0,0,0,0
905108190,70.0,7252,0.0,685,0,173,858,858,0,0,858,576,120,0,0,0,0,0,0
911226010,120.0,18000,0.0,0,0,894,894,894,0,0,894,1248,0,20,0,0,0,0,560
527225035,152.0,12134,0.0,427,0,132,559,1080,672,0,1752,492,325,12,0,0,0,0,0
527302210,85.0,14450,194.0,864,449,469,1782,1782,0,0,1782,551,467,0,0,0,0,0,0
909278020,54.0,7681,0.0,0,0,731,731,820,523,0,1343,186,192,0,102,0,0,0,0
528120020,87.0,11146,250.0,0,0,1709,1709,1717,0,0,1717,908,169,39,0,0,0,0,0
535452120,70.0,7910,0.0,666,0,409,1075,1507,0,0,1507,404,0,0,0,0,0,0,0
535453040,80.0,8000,0.0,520,319,188,1027,1027,0,0,1027,299,0,0,0,0,0,0,0
904352190,60.0,6048,0.0,736,0,120,856,936,744,0,1680,450,56,144,0,0,0,0,0
907262050,44.0,9548,223.0,483,0,458,941,941,888,0,1829,613,192,39,0,0,0,0,0
528172020,74.0,10927,280.0,546,0,512,1058,1058,846,0,1904,736,179,60,0,0,0,0,0
535305030,60.0,7350,0.0,852,0,100,952,952,0,0,952,840,0,0,0,0,0,0,0
902202070,50.0,5925,435.0,168,0,739,907,1131,0,0,1131,672,0,72,0,0,0,0,0
535456070,60.0,7200,0.0,370,0,398,768,1024,564,0,1588,480,0,0,0,0,0,0,0
527353060,60.0,12388,229.0,602,0,441,1043,1539,1134,0,2673,441,178,84,0,0,0,0,0
535327230,71.0,8838,0.0,0,0,0,0,1764,0,0,1764,301,0,72,0,0,0,0,0
907285040,80.0,10000,438.0,1079,0,141,1220,1220,870,0,2090,556,0,65,0,0,0,0,0
528344100,98.0,12203,975.0,854,0,371,1225,1276,1336,0,2612,676,250,0,0,0,0,0,0
904100160,115.0,21286,0.0,0,0,720,720,720,551,0,1271,312,0,0,108,0,0,0,0
916403130,115.0,11170,0.0,1216,0,0,1216,1298,1216,0,2514,693,0,0,0,0,0,0,0
527425060,70.0,10500,0.0,524,180,160,864,864,0,0,864,576,216,0,0,0,0,0,0
905200290,88.0,13125,67.0,168,682,284,1134,1803,0,0,1803,484,0,0,0,0,0,0,0
905401020,102.0,12671,300.0,353,0,935,1288,2422,0,0,2422,527,0,63,0,0,144,0,0
535325350,80.0,13600,0.0,144,912,0,1056,1056,0,0,1056,300,0,0,0,0,0,0,650
535355020,113.0,21281,0.0,0,0,666,666,1308,1778,0,3086,1200,0,208,290,0,156,0,0
903225160,59.0,5870,0.0,0,0,554,554,736,554,0,1290,200,38,112,0,0,0,0,400
907196020,118.0,13704,150.0,0,0,1541,1541,1541,0,0,1541,843,468,81,0,0,0,0,0
528108140,94.0,12220,305.0,1436,0,570,2006,2020,0,0,2020,900,156,54,0,0,0,0,0
533253070,61.0,3782,0.0,960,0,266,1226,1226,0,0,1226,484,133,78,0,0,0,0,0
907405140,65.0,8450,196.0,706,0,150,856,856,854,0,1710,548,0,61,0,0,0,0,0
914478020,65.0,8750,50.0,224,530,98,852,918,0,0,918,360,192,84,0,0,0,0,0
907280100,90.0,11248,215.0,1059,0,567,1626,1668,0,0,1668,702,257,45,0,0,0,0,0
908102050,67.0,8777,0.0,0,0,0,0,1126,0,0,1126,520,0,96,0,0,0,0,0
535303110,53.0,8128,80.0,490,0,572,1062,1062,0,0,1062,297,0,0,0,0,0,0,0
535354050,60.0,9600,0.0,220,0,625,845,893,0,0,893,576,0,0,0,0,0,0,0
528240150,61.0,10125,0.0,0,0,846,846,846,748,0,1594,434,300,48,0,0,0,0,0
909103020,76.0,11388,0.0,0,0,616,616,1055,218,0,1273,275,212,0,0,0,0,0,0
528118010,101.0,14215,380.0,0,0,1158,1158,1158,1218,0,2376,853,240,154,0,0,0,0,0
528181040,40.0,6792,94.0,0,0,1368,1368,1368,0,0,1368,474,132,35,0,0,0,0,0
534127270,90.0,11700,420.0,404,0,304,708,708,708,0,1416,776,0,169,0,0,119,0,0
533223110,90.0,4447,0.0,0,0,530,530,530,550,0,1080,496,0,50,0,0,0,0,0
535126100,120.0,13560,216.0,0,0,1392,1392,1392,0,0,1392,576,0,0,240,0,0,0,0
531452180,120.0,9453,0.0,402,0,594,996,1014,730,0,1744,457,370,70,0,238,0,0,0
534202030,60.0,10355,196.0,695,0,519,1214,1214,0,0,1214,318,0,111,0,0,0,0,0
910201130,60.0,6000,0.0,0,0,720,720,760,330,0,1090,240,0,0,0,0,0,0,0
533252020,60.0,11250,0.0,767,0,441,1208,1208,0,0,1208,546,198,42,0,0,0,0,0
527328010,65.0,10464,130.0,850,0,138,988,1102,0,0,1102,582,140,22,0,0,0,0,0
905325020,65.0,25095,0.0,1324,0,113,1437,1473,0,0,1473,452,0,48,0,0,60,0,0
902402260,60.0,11340,0.0,0,0,723,723,723,363,0,1086,400,0,24,144,0,0,0,0
903225150,50.0,5000,0.0,188,0,577,765,765,0,0,765,200,135,0,41,0,0,0,0
528354110,95.0,11787,594.0,719,0,660,1379,1383,1015,0,2398,834,239,60,0,0,0,0,0
907227060,60.0,7200,0.0,671,0,193,864,864,0,0,864,576,155,0,0,0,0,0,0
535103050,60.0,13700,288.0,454,0,410,864,902,918,0,1820,492,60,84,0,0,273,0,0
528435050,85.0,10130,260.0,1294,0,408,1702,1702,0,0,1702,844,0,69,0,0,0,0,0
528175010,44.0,6371,128.0,733,0,625,1358,1358,0,0,1358,484,192,35,0,0,0,0,0
903234100,51.0,6120,0.0,0,0,952,952,1022,752,0,1774,468,90,0,205,0,0,0,0
528480100,65.0,8125,0.0,0,0,756,756,756,797,0,1553,615,0,45,0,0,0,0,0
527368010,65.0,8470,0.0,225,276,471,972,972,839,0,1811,565,225,48,0,0,0,0,0
907280170,70.0,8750,209.0,1111,0,306,1417,1417,0,0,1417,511,60,0,0,0,117,0,0
535151100,65.0,6860,54.0,908,0,100,1008,1008,0,0,1008,308,0,0,0,0,0,0,0
906420020,80.0,10041,0.0,789,0,119,908,927,988,0,1915,506,120,150,0,0,0,0,0
908204090,64.0,6400,0.0,77,831,52,960,960,0,0,960,392,144,0,35,0,0,0,0
909451100,24.0,1488,0.0,471,0,90,561,561,668,0,1229,462,176,0,0,0,0,0,0
535152060,70.0,8176,0.0,846,0,210,1056,1056,0,0,1056,308,0,0,0,0,0,0,0
535477060,69.0,7590,266.0,512,0,148,660,660,688,0,1348,453,188,108,0,0,0,0,0
528351010,104.0,21535,1170.0,1455,0,989,2444,2444,1872,0,4316,832,382,50,0,0,0,0,0
903458060,40.0,4800,0.0,197,0,999,1196,1196,0,0,1196,440,0,0,0,0,0,0,0
528235160,59.0,11796,0.0,0,0,847,847,847,1112,0,1959,434,100,48,0,0,0,0,0
906426210,59.0,16698,0.0,800,0,649,1449,944,815,0,1759,525,150,193,0,0,0,0,0
907253110,50.0,10400,227.0,0,0,1257,1257,1290,871,0,2161,570,0,84,0,0,0,0,0
531452050,50.0,7175,0.0,623,121,0,744,752,0,0,752,264,353,0,0,0,90,0,0
923275200,76.0,8314,0.0,546,0,270,816,816,0,0,816,264,168,0,0,0,0,0,0
531453140,76.0,9180,0.0,747,93,0,840,884,0,0,884,504,240,0,0,0,0,0,0
906382030,86.0,11210,240.0,20,0,1594,1614,1614,0,0,1614,865,144,59,0,0,0,0,0
527163130,86.0,8803,0.0,600,0,107,707,707,809,0,1516,409,0,46,0,0,0,0,0
905105040,86.0,8665,89.0,168,288,420,876,897,0,0,897,264,0,0,0,0,0,0,0
906201023,116.0,13474,246.0,700,0,0,700,1122,1121,0,2243,746,127,44,224,0,0,0,0
533242030,60.0,7180,0.0,0,0,1568,1568,1568,0,0,1568,564,0,266,0,0,0,0,0
535302080,60.0,10950,0.0,339,0,525,864,1064,0,0,1064,318,0,0,0,0,0,0,0
527356050,80.0,10793,263.0,493,287,0,780,780,840,0,1620,462,208,0,0,0,0,0,0
531477050,70.0,9800,0.0,0,0,816,816,1012,0,0,1012,429,121,0,80,0,0,0,0
528218030,65.0,10237,0.0,28,0,1288,1316,1316,0,0,1316,397,100,0,0,23,0,0,0
905475500,65.0,11500,0.0,0,0,0,0,845,0,0,845,290,186,0,0,0,0,0,0
527106010,21.0,13006,285.0,0,0,964,964,993,1243,0,2236,642,0,0,0,0,0,0,0
923228130,21.0,1533,0.0,553,0,77,630,630,0,0,630,0,0,0,0,0,0,0,0
527162080,63.0,7875,0.0,414,0,277,691,691,862,0,1553,420,0,44,0,0,0,0,0
909276160,78.0,12168,0.0,428,0,537,965,1940,1254,0,3194,380,0,0,0,0,0,0,0
534401190,80.0,9200,0.0,892,0,244,1136,1136,0,0,1136,384,426,0,0,0,0,0,0
907425035,80.0,4438,169.0,662,0,186,848,848,0,0,848,420,140,0,0,0,0,0,0
527325240,90.0,13068,621.0,890,48,273,1211,1211,0,0,1211,461,0,0,0,174,0,0,0
533213020,90.0,4217,252.0,962,0,183,1145,1256,0,0,1256,641,0,169,0,0,0,0,0
910200060,50.0,7000,0.0,374,0,487,861,861,424,0,1285,506,96,0,132,0,0,0,0
902106060,60.0,6600,0.0,0,0,994,994,1378,994,0,2372,432,0,287,0,0,0,0,0
906382040,73.0,8990,0.0,0,0,1498,1498,1498,0,0,1498,675,351,33,0,0,0,0,0
903236130,47.0,7755,0.0,0,0,1100,1100,1100,1164,0,2264,408,0,152,0,0,0,0,0
534128010,47.0,10382,240.0,859,32,216,1107,1107,983,0,2090,484,235,204,228,0,0,0,350
528138030,85.0,11924,286.0,998,0,177,1175,1182,1142,0,2324,736,147,21,0,0,0,0,0
528228415,85.0,3072,18.0,0,0,1375,1375,1414,0,0,1414,398,144,20,0,0,0,0,0
904302260,60.0,9900,0.0,1026,0,186,1212,1212,180,0,1392,0,0,0,168,0,0,0,0
903227070,50.0,6000,0.0,0,0,884,884,884,464,0,1348,216,0,0,208,0,0,0,0
924100020,50.0,11075,232.0,562,193,29,784,1168,800,0,1968,530,305,189,0,0,0,0,400
908152035,80.0,10682,0.0,399,0,615,1014,1149,0,0,1149,544,0,240,0,0,0,0,0
528221060,149.0,12589,0.0,0,0,742,742,742,742,0,1484,390,36,24,0,0,0,0,0
533254110,80.0,9600,200.0,0,0,392,392,1487,1012,0,2499,527,0,64,0,0,0,0,0
528231030,65.0,16219,0.0,779,0,56,835,1119,0,0,1119,437,100,24,0,0,0,0,0
531452140,55.0,7892,0.0,300,0,899,1199,1199,0,0,1199,530,0,63,0,0,0,0,0
906392090,90.0,13377,0.0,1576,0,260,1836,1846,0,0,1846,495,0,32,0,0,0,0,0
907202080,90.0,7000,90.0,646,0,218,864,864,0,0,864,336,0,0,0,0,0,0,0
909281130,70.0,10570,0.0,297,0,556,853,1549,1178,0,2727,440,0,74,0,0,0,0,0
903205040,70.0,8854,0.0,0,0,952,952,952,0,0,952,192,0,98,0,0,40,0,0
923225190,41.0,2665,0.0,0,0,264,264,616,688,0,1304,336,141,0,0,0,0,0,0
528458120,75.0,9000,0.0,0,0,1088,1088,1088,871,0,1959,1025,208,46,0,0,0,0,0
905378040,124.0,18600,0.0,288,684,0,972,1052,558,0,1610,480,0,0,60,0,0,0,450
527450080,24.0,2160,200.0,402,0,363,765,765,600,0,1365,440,0,36,0,0,0,0,0
527357110,75.0,9743,0.0,280,0,440,720,720,588,0,1308,484,0,0,0,0,0,0,0
534204030,65.0,8125,0.0,260,456,196,912,925,0,0,925,576,233,0,0,0,0,0,0
902205070,62.0,7311,0.0,0,0,407,407,407,0,0,407,297,76,0,120,0,0,0,0
535179020,80.0,10032,432.0,734,0,510,1244,1580,0,0,1580,440,0,28,0,0,160,0,0
534402060,115.0,10500,144.0,998,0,294,1292,1292,0,0,1292,520,0,32,0,0,92,0,0
533241010,114.0,8314,0.0,0,0,569,569,854,840,0,1694,434,0,382,0,0,110,0,0
906340120,61.0,10226,270.0,0,0,1622,1622,1630,0,0,1630,860,172,42,0,0,0,0,0
533110130,121.0,16059,284.0,0,0,1288,1288,1301,1116,0,2417,462,127,82,0,0,0,0,0
903232060,51.0,6120,0.0,0,0,960,960,995,0,0,995,264,0,15,51,0,0,0,0
903231010,51.0,6120,0.0,0,0,927,927,1067,472,0,1539,576,112,0,0,0,0,0,0
1007100110,51.0,56600,0.0,0,0,686,686,1150,686,0,1836,288,0,0,0,0,0,0,0
534201130,75.0,9750,0.0,400,480,100,980,980,0,0,980,384,68,0,0,0,0,0,0
528228345,75.0,3940,143.0,1073,0,342,1415,1455,0,0,1455,644,156,20,0,0,144,0,0
528106050,107.0,13641,456.0,1304,0,630,1934,1943,713,0,2656,1040,268,58,0,0,0,0,0
533253050,36.0,3640,0.0,860,0,176,1036,1036,0,0,1036,484,133,108,0,0,0,0,0
908102130,75.0,9825,0.0,0,0,0,0,1664,0,0,1664,0,0,0,0,0,0,0,0
902301030,60.0,9600,0.0,0,0,702,702,842,630,0,1472,250,0,0,84,0,0,0,0
535383060,90.0,5400,0.0,0,0,416,416,599,0,0,599,0,0,81,0,0,0,0,0
527455090,24.0,2104,0.0,536,0,300,836,836,0,0,836,345,150,20,0,0,0,0,0
528221040,63.0,9729,0.0,0,0,698,698,698,1048,0,1746,350,0,34,0,0,0,0,0
527378010,80.0,10000,176.0,755,0,348,1103,1103,0,0,1103,462,295,84,0,0,0,0,0
906385020,64.0,7360,80.0,24,0,1198,1222,1222,0,0,1222,615,0,54,0,0,0,0,0
909175050,60.0,8400,0.0,378,0,342,720,1052,720,420,2192,240,262,24,0,0,0,0,0
903454090,50.0,9000,0.0,0,0,780,780,780,595,0,1375,544,0,162,0,0,126,0,0
923228210,21.0,1526,0.0,0,0,546,546,546,546,0,1092,0,0,34,0,0,0,0,0
909425085,70.0,12392,0.0,435,0,397,832,1218,943,0,2161,506,0,96,0,0,0,0,0
907125040,70.0,14217,0.0,550,0,472,1022,1022,0,0,1022,747,0,0,0,0,0,0,0
527427160,33.0,4113,0.0,0,0,1337,1337,1337,0,0,1337,511,136,68,0,0,0,0,0
906477110,80.0,8816,80.0,504,0,506,1010,1052,0,0,1052,440,0,0,0,0,0,0,0
527402380,71.0,9353,0.0,0,0,864,864,864,0,0,864,280,0,0,0,0,0,0,0
923228110,21.0,1477,0.0,509,0,121,630,630,0,0,630,286,0,0,0,0,0,0,0
923203010,62.0,6710,134.0,16,904,0,920,936,0,0,936,460,0,40,0,0,0,0,0
906204140,82.0,11287,340.0,421,0,386,807,1175,807,0,1982,575,0,84,0,196,0,0,0
528150120,99.0,12099,388.0,970,0,166,1136,1136,1332,0,2468,872,184,154,0,0,0,0,0
907290020,75.0,9750,0.0,975,0,133,1108,1108,989,0,2097,583,253,170,0,0,0,0,0
535301080,60.0,11556,52.0,148,0,572,720,882,0,0,882,240,0,0,0,0,0,0,0
527451520,21.0,1680,297.0,0,0,483,483,483,504,0,987,288,0,0,0,0,0,0,0
528108150,98.0,12704,302.0,1012,0,570,1582,1582,0,0,1582,905,209,95,0,0,0,0,0
903233030,51.0,6120,0.0,351,0,405,756,903,378,0,1281,379,25,0,0,0,0,0,0
528315060,84.0,9660,1290.0,0,0,1173,1173,1182,1017,0,2199,516,0,131,0,0,0,0,0
903232030,84.0,6120,0.0,0,0,0,0,808,0,0,808,164,0,48,0,0,0,0,0
906475070,91.0,28698,0.0,249,764,0,1013,1160,966,0,2126,538,486,0,0,0,225,0,0
528431080,91.0,12274,256.0,0,0,1417,1417,1428,0,0,1428,554,0,60,0,0,0,0,0
903476100,55.0,4388,0.0,116,0,556,672,840,0,0,840,0,0,0,0,0,0,0,0
905476225,39.0,3869,149.0,283,755,0,1038,1038,0,0,1038,264,0,105,0,0,0,0,0
527453050,24.0,2308,0.0,306,0,498,804,804,744,0,1548,440,108,0,0,0,0,0,0
902128100,40.0,4400,0.0,0,0,648,648,734,384,0,1118,440,0,0,0,0,0,0,0
909282110,70.0,14210,0.0,0,0,697,697,1104,697,0,1801,365,0,90,0,0,0,0,0
527404100,61.0,9758,0.0,412,287,251,950,950,0,0,950,280,0,0,0,0,0,0,0
533208080,35.0,4017,0.0,0,0,625,625,625,625,0,1250,625,0,54,0,0,0,0,0
907130060,105.0,11249,0.0,334,544,322,1200,1200,0,0,1200,521,0,26,0,0,0,0,0
534202180,80.0,9600,140.0,602,402,137,1141,1141,0,0,1141,568,0,78,0,0,0,0,0
527452150,53.0,4043,0.0,559,0,510,1069,1069,0,0,1069,440,0,55,0,0,200,0,0
907200110,53.0,9200,0.0,280,491,167,938,938,0,0,938,308,145,0,0,0,0,0,0
531375090,63.0,13072,0.0,0,0,1114,1114,1114,0,0,1114,0,0,39,0,0,0,0,0
533213010,63.0,3830,280.0,0,0,1726,1726,1726,0,0,1726,561,0,254,0,0,0,0,0
535455080,59.0,7227,0.0,0,0,832,832,832,0,0,832,528,0,0,0,0,0,0,0
909254010,53.0,7155,0.0,0,0,600,600,628,600,0,1228,215,0,113,0,0,195,0,0
923205015,53.0,11875,0.0,0,0,1344,1344,1344,0,0,1344,686,328,0,0,0,0,0,0
535325090,71.0,8540,0.0,114,691,120,925,925,0,0,925,252,152,0,0,0,0,0,0
908203090,64.0,6410,0.0,332,243,301,876,876,0,0,876,320,0,0,0,0,0,0,0
907125090,82.0,11105,0.0,870,0,0,870,965,0,0,965,580,71,0,0,0,0,0,0
535176100,90.0,13200,187.0,958,0,437,1395,1570,0,0,1570,441,490,0,0,0,0,0,0
910200080,50.0,7000,0.0,299,40,555,894,919,0,0,919,195,0,0,116,0,0,0,0
534128050,80.0,11040,144.0,656,0,602,1258,1258,0,0,1258,528,55,0,0,216,0,0,0
907290240,80.0,4426,169.0,662,0,186,848,848,0,0,848,420,160,0,0,0,0,0,0
905225020,99.0,16779,356.0,267,0,404,671,1567,1087,0,2654,638,128,570,0,0,0,0,500
902102080,60.0,10440,0.0,0,0,440,440,682,548,0,1230,440,74,0,128,0,0,0,0
535380140,60.0,10836,0.0,0,0,892,892,1254,182,0,1436,1488,0,0,100,0,0,0,0
923227100,80.0,13384,194.0,119,344,641,1104,1360,0,0,1360,336,160,0,0,0,0,0,0
527108060,42.0,13751,248.0,60,0,1640,1700,1700,512,0,2212,773,237,38,0,0,115,0,0
902106120,56.0,4480,0.0,782,0,240,1022,1022,0,0,1022,184,0,122,20,0,0,0,0
534403420,56.0,11382,212.0,54,543,533,1130,1374,0,0,1374,286,0,28,84,0,0,0,0
535153150,76.0,9120,0.0,662,0,599,1261,1261,0,0,1261,433,0,0,0,0,288,0,1400
532354090,88.0,11782,0.0,899,0,210,1109,1155,0,0,1155,576,192,0,0,0,0,0,400
532376040,85.0,6970,0.0,932,0,108,1040,1120,0,0,1120,544,168,0,0,0,0,0,400
906380060,77.0,11422,352.0,1359,0,479,1838,1838,0,0,1838,524,154,222,0,0,0,0,0
534102025,80.0,8000,0.0,833,0,659,1492,1492,0,0,1492,596,277,137,0,0,0,0,0
902105050,90.0,15660,0.0,0,0,240,240,810,496,0,1306,472,0,0,0,0,0,0,0
923230120,50.0,6723,0.0,796,0,0,796,796,0,0,796,0,129,0,0,0,0,0,0
535105030,75.0,7875,136.0,572,0,572,1144,1144,0,0,1144,456,0,0,0,0,0,0,0
903401050,75.0,9144,0.0,399,0,484,883,988,517,0,1505,240,0,0,0,0,0,0,0
916475040,85.0,14601,584.0,1260,0,578,1838,1838,0,0,1838,765,270,68,0,0,0,0,0
534128020,85.0,12732,0.0,560,42,150,752,1285,782,0,2067,784,297,40,0,0,0,0,0
902306120,60.0,6000,0.0,0,0,572,572,884,656,0,1540,0,240,77,0,0,0,0,0
923277040,60.0,6600,0.0,816,0,0,816,816,0,0,816,816,0,0,0,0,0,0,0
903450110,110.0,8472,0.0,104,712,0,816,816,0,0,816,516,106,0,0,0,0,0,0
528102050,96.0,12469,378.0,1151,0,639,1790,1816,0,0,1816,730,186,36,0,0,0,0,0
903232100,52.0,6240,0.0,0,0,966,966,1014,412,0,1426,230,174,0,96,0,0,0,0
907265010,52.0,11250,0.0,0,0,944,944,944,926,0,1870,608,256,43,0,0,0,0,0
907200130,97.0,11800,0.0,663,0,201,864,894,0,0,894,440,0,0,0,0,0,0,0
527327080,97.0,18800,120.0,712,0,84,796,790,784,0,1574,566,306,111,0,0,0,0,0
528228580,53.0,4045,45.0,1070,0,286,1356,1500,0,0,1500,648,161,20,0,0,0,0,0
909250160,55.0,10594,0.0,0,0,768,768,789,0,0,789,200,0,0,112,0,0,0,0
902204060,50.0,6000,0.0,576,0,384,960,960,0,0,960,576,0,0,0,0,0,0,0
527404120,70.0,8400,0.0,804,78,0,882,882,0,0,882,525,240,0,0,0,0,0,0
905453040,83.0,10420,0.0,36,0,1176,1212,1212,0,0,1212,460,100,22,0,0,0,0,0
909129090,70.0,6300,88.0,832,0,0,832,832,436,0,1268,250,0,0,55,0,0,0,0
908226120,60.0,12180,0.0,0,0,585,585,585,468,0,1053,0,42,0,0,0,0,0,0
906340090,77.0,9965,340.0,1150,0,316,1466,1466,1362,0,2828,1052,125,144,0,0,0,0,0
907175080,77.0,8696,150.0,1308,0,110,1418,1418,0,0,1418,558,208,110,0,0,0,0,0
909275160,126.0,13108,0.0,0,0,0,0,1226,0,0,1226,400,174,24,120,0,228,0,0
535454150,60.0,8064,0.0,315,0,453,768,819,501,0,1320,576,108,0,0,0,0,0,0
903231060,51.0,6120,0.0,0,0,264,264,800,0,0,800,0,0,0,0,0,0,0,0
528222040,73.0,8899,0.0,24,0,1316,1340,1340,0,0,1340,396,100,30,0,0,0,0,0
907270050,67.0,10566,261.0,920,0,170,1090,1090,1124,0,2214,646,197,80,0,0,0,0,0
908204180,74.0,6882,128.0,0,0,0,0,1152,0,0,1152,0,0,0,0,0,0,0,0
528250100,74.0,7750,0.0,250,0,134,384,774,656,0,1430,400,180,0,0,0,0,0,0
906392070,64.0,7314,82.0,724,0,508,1232,1232,0,0,1232,632,132,0,0,0,0,0,0
906226070,64.0,7018,0.0,0,0,0,0,1535,0,0,1535,410,0,0,0,0,0,0,0
535451250,60.0,7200,0.0,180,352,676,1208,1136,768,0,1904,240,0,0,168,0,0,0,0
532376170,65.0,8450,0.0,890,0,0,890,890,0,0,890,308,0,0,0,0,0,0,0
902107030,60.0,6000,0.0,0,0,728,728,728,728,0,1456,308,0,0,248,0,0,0,0
531477040,60.0,8400,320.0,0,0,0,0,2020,0,0,2020,630,0,0,0,0,0,0,0
907410020,70.0,8145,0.0,0,0,738,738,738,738,0,1476,552,0,35,0,0,0,0,0
534275220,80.0,8892,66.0,0,0,1065,1065,1065,0,0,1065,461,74,0,0,0,0,0,0
527127100,28.0,7296,0.0,1965,0,243,2208,2522,0,0,2522,564,182,57,0,0,0,0,0
531375060,63.0,13072,0.0,0,0,1131,1131,1131,0,0,1131,0,0,39,0,0,0,0,0
909426080,78.0,15600,430.0,375,0,657,1032,1102,1075,0,2177,484,0,0,0,0,0,0,0
909250060,50.0,9638,0.0,0,0,804,804,1699,748,0,2447,336,272,0,42,0,116,0,0
907227030,36.0,15523,0.0,460,0,404,864,864,0,0,864,338,0,0,0,0,0,0,0
909101070,45.0,8212,0.0,203,0,661,864,864,0,0,864,200,0,0,96,0,0,0,0
916386080,73.0,9735,0.0,0,0,384,384,754,640,0,1394,400,100,0,0,0,0,0,0
533221110,73.0,2980,1159.0,466,0,290,756,756,756,0,1512,440,0,32,0,0,0,0,0
908188130,24.0,2522,50.0,0,0,970,970,970,739,0,1709,380,0,40,0,0,0,0,0
527359030,80.0,10400,120.0,0,0,1444,1444,1444,0,0,1444,473,0,24,0,0,0,0,0
534429130,80.0,10800,88.0,632,0,616,1248,1248,0,0,1248,286,0,0,0,0,0,0,0
902102060,60.0,10440,0.0,0,0,650,650,958,581,0,1539,686,70,78,68,0,0,0,0
916380070,89.0,12898,70.0,1022,0,598,1620,1620,0,0,1620,912,228,0,0,0,0,0,0
905108220,74.0,8740,0.0,672,0,168,840,860,0,0,860,528,0,0,0,0,0,0,0
528480090,84.0,10440,0.0,1414,0,54,1468,1468,0,0,1468,528,0,102,0,0,216,0,0
916384150,89.0,10991,80.0,0,0,1571,1571,1571,0,0,1571,722,100,36,0,0,0,0,0
534127140,89.0,8723,0.0,973,0,0,973,1082,0,0,1082,480,160,0,0,0,0,0,0
910203230,50.0,7030,0.0,0,0,641,641,641,0,0,641,272,184,0,70,0,0,0,0
907252020,50.0,9375,149.0,0,0,1284,1284,1284,885,0,2169,647,192,87,0,0,0,0,0
533223020,24.0,2572,0.0,604,0,92,696,696,720,0,1416,484,0,44,0,0,0,0,0
908186040,35.0,3675,80.0,459,0,88,547,1072,0,0,1072,525,0,28,0,0,0,0,0
528292040,35.0,24682,0.0,0,0,841,841,892,783,0,1675,502,0,103,0,0,0,0,0
535457090,81.0,7635,0.0,588,350,237,1175,1175,0,0,1175,484,0,0,0,0,0,0,0
535376090,90.0,5400,0.0,415,0,418,833,833,0,0,833,326,0,0,0,0,0,0,0
903236200,58.0,6380,0.0,0,0,993,993,1048,0,0,1048,280,0,0,116,0,0,0,0
527402060,65.0,9750,0.0,602,438,14,1054,1054,0,0,1054,460,180,0,0,0,80,0,0
534451080,65.0,6627,0.0,0,0,0,0,720,0,0,720,287,0,0,0,0,0,0,0
535380010,60.0,7200,0.0,338,0,325,663,774,821,0,1595,528,49,0,231,0,0,0,0
907401060,65.0,8200,0.0,0,0,847,847,847,1081,0,1928,434,100,48,0,0,0,0,0
902103120,57.0,10307,0.0,633,0,339,972,972,972,0,1944,324,0,28,169,0,0,0,0
528387050,81.0,10944,448.0,1000,0,223,1223,1223,904,0,2127,525,171,132,0,0,0,0,0
535300120,120.0,19296,399.0,672,690,0,1362,1382,0,0,1382,884,0,0,252,0,0,0,0
527328020,120.0,10395,233.0,605,0,427,1032,1032,0,0,1032,564,0,0,0,0,0,0,500
906200230,104.0,23920,0.0,0,0,1105,1105,1105,717,0,1822,515,0,195,1012,0,0,444,0
534127230,85.0,11050,0.0,301,0,1439,1740,1740,0,0,1740,512,25,0,0,0,192,0,0
527325160,85.0,16659,34.0,795,0,0,795,1468,795,0,2263,539,0,250,0,0,0,0,0
528118030,108.0,13418,270.0,1420,0,430,1850,1850,898,0,2748,850,212,182,0,0,0,0,0
906380110,133.0,11003,0.0,0,0,1308,1308,1308,568,0,1876,848,0,40,0,0,0,0,0
534431050,68.0,9724,265.0,670,0,470,1140,1929,532,0,2461,400,0,0,0,0,0,0,0
909250230,64.0,7804,0.0,281,679,0,960,960,960,0,1920,480,248,0,121,0,0,0,0
923251180,160.0,20000,0.0,1224,0,0,1224,1224,0,0,1224,576,474,0,0,0,0,0,0
907250050,80.0,10386,246.0,1464,0,536,2000,2000,0,0,2000,888,168,0,0,0,0,0,0
528458030,72.0,8640,0.0,24,0,1339,1363,1372,0,0,1372,588,192,113,0,0,0,0,0
533206020,32.0,2880,0.0,0,0,1376,1376,1376,1629,0,3005,704,0,177,0,0,0,0,0
533135020,32.0,11949,196.0,601,216,158,975,975,780,0,1755,524,502,60,0,0,0,0,0
903206070,62.0,7010,0.0,175,0,849,1024,1144,594,0,1738,240,0,30,0,0,0,0,0
923400125,62.0,10441,0.0,337,0,575,912,970,0,0,970,0,80,32,0,0,0,0,700
535350030,85.0,10200,104.0,320,362,404,1086,1086,0,0,1086,490,0,0,0,0,0,0,0
905478030,60.0,11409,0.0,292,0,476,768,1148,568,0,1716,281,0,0,0,0,160,0,0
923225300,60.0,1974,0.0,334,0,212,546,546,546,0,1092,286,120,96,0,0,0,0,0
909275250,66.0,21780,0.0,0,0,817,817,940,610,0,1550,318,0,0,429,0,0,0,0
907227300,60.0,7200,0.0,632,0,148,780,780,0,0,780,352,196,0,0,0,0,0,0
528322020,100.0,12191,515.0,1181,0,598,1779,1779,772,0,2551,925,76,61,0,0,0,0,0
534128090,108.0,11358,0.0,346,0,778,1124,1610,0,0,1610,515,202,0,0,0,256,0,0
528294010,59.0,9649,0.0,0,0,941,941,961,683,0,1644,460,460,42,0,0,0,0,0
528429050,75.0,11957,53.0,24,0,1550,1574,1574,0,0,1574,824,144,104,0,0,0,0,0
531384070,75.0,11613,0.0,480,0,384,864,920,900,0,1820,492,144,85,0,0,0,0,0
534176230,80.0,9600,0.0,329,0,386,715,930,715,0,1645,441,0,78,0,0,0,0,0
531382120,65.0,8125,258.0,1138,0,270,1408,1679,0,0,1679,575,224,42,0,0,0,0,0
527256120,90.0,18261,420.0,1416,0,494,1910,2000,0,0,2000,722,351,102,0,0,123,0,0
909282130,70.0,9100,0.0,154,694,264,1112,1112,0,0,1112,390,0,0,0,0,0,0,0
531379030,70.0,8304,0.0,0,0,941,941,941,896,0,1837,688,150,165,0,0,0,0,0
535375010,53.0,5470,0.0,0,0,792,792,792,0,0,792,366,0,90,0,0,0,0,0
905200010,53.0,8169,0.0,216,435,261,912,912,0,0,912,315,204,0,0,0,0,0,0
527258020,124.0,16158,16.0,1274,0,256,1530,1530,0,0,1530,430,168,36,0,0,0,0,0
910203290,59.0,8263,0.0,0,0,1012,1012,1012,0,0,1012,308,0,22,112,0,0,0,0
905351150,59.0,5271,0.0,1082,0,371,1453,1453,0,0,1453,445,0,80,0,0,184,0,0
527328050,79.0,11850,98.0,781,0,372,1153,1177,0,0,1177,495,204,103,0,0,0,0,0
916382010,83.0,13159,0.0,0,0,846,846,846,846,0,1692,650,208,114,0,0,0,0,0
528142070,82.0,11643,142.0,880,0,644,1524,1544,814,0,2358,784,120,34,0,0,0,0,0
905452070,50.0,9350,0.0,864,0,0,864,864,0,0,864,0,0,0,0,0,0,0,0
907401090,48.0,10635,171.0,370,972,315,1657,1668,0,0,1668,502,0,262,0,0,0,0,0
907425030,48.0,4438,205.0,662,0,186,848,848,0,0,848,420,149,0,0,0,0,0,0
908152270,60.0,7024,0.0,1024,0,108,1132,1132,0,0,1132,451,252,64,0,0,0,0,0
531475220,75.0,8250,0.0,0,0,0,0,964,918,0,1882,612,0,0,0,0,0,0,0
526350040,80.0,11622,0.0,468,144,270,882,896,0,0,896,730,140,0,0,0,120,0,0
533251110,80.0,12000,600.0,1732,0,270,2002,2362,0,0,2362,546,180,16,0,0,0,0,0
526353030,93.0,11160,0.0,1065,0,1045,2110,2110,0,0,2110,522,0,0,0,0,0,0,0
923229010,93.0,11333,0.0,539,0,490,1029,1062,0,0,1062,539,120,0,0,0,0,0,0
534479320,78.0,7800,200.0,540,0,728,1268,1268,0,0,1268,244,0,98,0,0,0,0,0
535325290,60.0,10434,0.0,0,0,1005,1005,1005,0,0,1005,672,0,0,0,0,0,0,0
528120120,90.0,11520,615.0,110,0,1588,1698,1698,0,0,1698,730,192,74,0,0,0,0,0
528490040,68.0,8736,0.0,771,360,422,1553,1553,0,0,1553,588,192,88,0,0,0,0,0
902300090,33.0,4456,0.0,0,0,736,736,736,716,0,1452,0,0,0,102,0,0,0,0
534476100,80.0,9600,144.0,996,0,60,1056,1216,0,0,1216,280,0,0,0,0,0,0,0
527402210,80.0,15870,0.0,75,791,230,1096,1096,0,0,1096,299,240,32,0,0,0,0,0
903225140,50.0,5000,0.0,600,0,72,672,832,378,0,1210,240,0,0,0,0,0,0,0
905425125,75.0,45600,0.0,0,0,907,907,1307,1051,0,2358,360,486,40,0,0,175,0,0
916225130,42.0,26178,293.0,965,0,245,1210,1238,1281,0,2519,628,320,27,0,0,0,0,0
533236050,24.0,2645,456.0,649,0,321,970,983,756,0,1739,480,115,0,0,0,0,0,0
534477270,80.0,9600,0.0,831,0,161,992,1661,0,0,1661,377,0,28,0,0,178,0,0
535325460,118.0,21299,0.0,0,0,929,929,2039,0,0,2039,791,0,0,90,0,0,0,0
907412070,65.0,8450,266.0,946,0,490,1436,1436,0,0,1436,484,139,98,0,0,0,0,0
528478030,75.0,9375,768.0,0,0,1053,1053,1053,939,0,1992,648,140,45,0,0,0,0,0
907201060,65.0,8385,220.0,595,0,390,985,985,0,0,985,328,210,0,0,0,0,0,0
527451650,21.0,1680,268.0,231,0,399,630,630,672,0,1302,264,185,0,0,0,0,0,0
528326030,84.0,14260,350.0,655,0,490,1145,1145,1053,0,2198,836,192,84,0,0,0,0,0
914460020,80.0,10000,166.0,585,0,856,1441,1392,0,0,1392,650,168,49,0,0,0,0,0
527326040,85.0,11900,209.0,822,0,564,1386,1411,0,0,1411,544,192,0,0,0,0,0,0
534431030,68.0,9724,0.0,0,0,938,938,1043,0,0,1043,273,125,48,0,0,0,0,0
528106120,110.0,16163,232.0,0,0,1618,1618,1618,0,0,1618,880,0,0,0,0,0,0,0
902205020,50.0,5925,0.0,122,448,0,570,761,380,0,1141,252,0,0,96,0,0,0,0
528458040,72.0,8640,72.0,936,0,364,1300,1314,0,0,1314,552,135,112,0,0,0,0,0
528280130,93.0,10261,318.0,0,0,936,936,962,830,0,1792,451,0,0,0,0,0,0,0
907252060,93.0,12334,198.0,0,0,1068,1068,1068,1116,0,2184,570,192,132,0,0,0,0,0
914476050,78.0,10530,90.0,975,0,0,975,1004,0,0,1004,504,0,0,0,0,0,0,0
526302120,78.0,11765,302.0,1127,0,490,1617,1797,0,0,1797,963,0,0,0,0,0,0,0
923400025,85.0,14115,0.0,732,0,64,796,796,566,0,1362,480,40,30,0,320,0,0,700
902202090,75.0,9000,0.0,445,0,459,904,904,595,0,1499,869,0,20,0,0,0,0,0
534128100,75.0,12936,0.0,593,0,130,723,735,660,0,1395,497,294,116,0,0,0,0,0
905101450,70.0,8414,0.0,663,0,396,1059,1068,0,0,1068,264,192,0,0,0,0,0,0
535175180,87.0,10725,91.0,936,0,270,1206,1206,0,0,1206,312,0,21,0,0,0,0,0
907192130,88.0,12803,99.0,922,0,572,1494,1494,0,0,1494,530,192,36,0,0,0,0,0
527359180,88.0,10304,44.0,381,0,399,780,1088,780,0,1868,484,448,96,0,0,0,0,0
908275300,68.0,8562,145.0,383,0,833,1216,1526,0,0,1526,364,116,78,0,0,0,0,0
902206240,68.0,8239,0.0,176,0,832,1008,1060,185,0,1245,315,0,0,334,0,0,0,0
527163070,68.0,9765,68.0,310,0,370,680,680,790,0,1470,420,232,63,0,0,0,0,480
905225090,80.0,15584,366.0,0,0,825,825,2071,0,0,2071,336,131,28,0,0,0,0,0
907180050,80.0,9337,0.0,353,0,525,878,892,800,0,1692,513,0,39,0,0,0,0,0
534127080,80.0,8000,525.0,915,0,93,1008,1403,1008,0,2411,570,0,192,0,0,0,0,0
902101010,80.0,3950,0.0,468,0,350,818,818,406,0,1224,210,0,0,116,0,0,0,0
921205030,88.0,11443,208.0,1460,0,408,1868,2028,0,0,2028,880,326,66,0,0,0,0,0
528431020,86.0,11194,240.0,0,0,1696,1696,1696,0,0,1696,972,120,56,0,0,0,0,0
902101050,60.0,9600,264.0,276,0,936,1212,1226,442,0,1668,240,0,0,140,0,0,0,0
527454200,24.0,2280,0.0,311,0,544,855,855,601,0,1456,440,26,0,0,0,0,0,0
534403370,24.0,12095,115.0,564,0,563,1127,1445,0,0,1445,645,180,0,0,0,0,0,0
923204050,94.0,25286,0.0,633,0,431,1064,1040,0,0,1040,648,0,0,0,0,0,0,0
527450220,21.0,2058,265.0,0,0,672,672,672,546,0,1218,264,0,28,0,0,0,0,0
528110040,107.0,13891,456.0,1812,0,740,2552,2552,0,0,2552,932,130,28,0,0,0,0,0
911102180,52.0,5150,0.0,0,0,356,356,671,378,0,1049,195,0,0,0,0,0,0,0
908152290,60.0,7023,0.0,611,0,123,734,734,674,0,1408,489,0,85,0,0,0,0,0
528186190,48.0,6240,176.0,24,0,1300,1324,1324,0,0,1324,550,0,38,0,0,0,0,0
914475010,75.0,9750,0.0,767,0,135,902,926,0,0,926,351,319,0,0,0,0,0,0
907280040,75.0,9375,0.0,0,0,1040,1040,1044,1054,0,2098,621,331,38,0,0,0,0,0
905100030,75.0,11235,51.0,547,0,504,1051,1382,0,0,1382,459,0,82,0,0,0,0,0
909425140,110.0,14442,106.0,1186,0,291,1477,1839,0,0,1839,416,0,87,0,0,200,0,0
903426160,57.0,8094,0.0,196,0,1046,1242,1242,742,0,1984,360,64,0,180,0,0,0,1000
916477010,95.0,13618,198.0,1350,0,378,1728,1960,0,0,1960,714,172,38,0,0,0,0,0
527107130,60.0,8400,32.0,284,0,100,384,958,670,0,1628,390,48,72,0,0,0,0,490
907414070,65.0,8769,0.0,709,0,460,1169,1190,0,0,1190,578,100,41,0,0,0,0,0
916477020,85.0,12244,226.0,871,0,611,1482,1482,780,0,2262,749,168,0,0,0,0,0,0
527164020,58.0,7250,45.0,0,0,1181,1181,1190,0,0,1190,430,0,21,0,0,0,0,0
528354060,92.0,9920,0.0,862,0,255,1117,1127,886,0,2013,455,180,130,0,0,0,0,0
535425050,86.0,11650,58.0,0,0,0,0,1472,0,0,1472,484,0,68,0,0,227,0,0
534252060,86.0,10624,84.0,40,264,1424,1728,1728,0,0,1728,352,155,0,0,0,0,0,0
526353050,86.0,12925,0.0,865,0,340,1205,2117,0,0,2117,550,0,42,0,0,0,0,0
909277070,75.0,9260,0.0,0,0,884,884,932,442,0,1374,225,64,0,0,0,100,0,0
534175140,75.0,9750,0.0,0,0,1625,1625,1625,0,0,1625,484,0,0,0,0,0,0,0
916386180,81.0,12018,60.0,0,0,796,796,796,816,0,1612,666,0,64,0,0,0,0,0
534275170,81.0,12772,0.0,498,0,460,958,958,0,0,958,301,0,0,0,0,0,0,15500
908275180,60.0,8172,0.0,0,0,941,941,997,473,0,1470,548,0,0,0,0,156,0,0
909176170,60.0,10890,0.0,371,0,925,1296,1296,1296,0,2592,0,0,742,240,0,0,0,1512
533221030,60.0,2117,513.0,420,0,336,756,756,756,0,1512,440,0,32,0,0,0,0,0
527216010,92.0,15922,550.0,0,0,1390,1390,1390,1405,0,2795,660,272,102,0,0,0,0,0
910205020,60.0,6402,0.0,0,0,596,596,596,596,0,1192,189,0,0,137,0,0,0,0
907227110,60.0,7200,0.0,660,0,108,768,768,0,0,768,396,192,0,0,0,0,0,0
534451050,51.0,4712,0.0,384,0,363,747,774,456,0,1230,305,0,57,0,0,63,0,0
905201120,51.0,13284,0.0,1064,0,319,1383,1383,0,0,1383,354,511,116,0,0,0,0,0
906378120,71.0,9178,306.0,0,0,1643,1643,1651,0,0,1651,870,204,64,0,0,0,0,0
909451020,24.0,1879,0.0,366,0,150,516,516,516,0,1032,462,213,0,0,0,0,0,0
914465040,48.0,12822,0.0,1351,0,83,1434,1518,631,0,2149,670,168,43,0,0,198,0,0
535153140,82.0,9840,0.0,1053,0,195,1248,1440,0,0,1440,480,150,0,0,0,256,0,0
527358200,85.0,10625,81.0,885,168,0,1053,1173,0,0,1173,528,0,120,0,0,0,0,0
907265030,85.0,8125,295.0,986,0,668,1654,1654,0,0,1654,900,0,136,0,0,0,0,0
906202040,85.0,11200,85.0,1258,0,40,1298,1298,0,0,1298,403,165,26,0,0,0,0,0
533130130,85.0,13143,504.0,250,981,0,1231,1251,1098,0,2349,762,32,130,0,0,0,0,0
904101110,100.0,15263,90.0,766,0,656,1422,1675,0,0,1675,365,0,132,0,0,0,0,0
533253180,40.0,3840,0.0,881,176,0,1057,1295,0,0,1295,571,133,89,0,0,0,0,0
909455060,35.0,3907,0.0,577,0,427,1004,1020,0,0,1020,509,135,0,0,0,0,0,0
528144020,79.0,9541,268.0,0,0,1502,1502,1502,0,0,1502,644,0,114,0,0,0,0,0
906380130,68.0,8814,180.0,1334,0,270,1604,1604,0,0,1604,660,123,110,0,0,0,0,0
527325090,61.0,11339,549.0,758,0,22,780,1085,845,0,1930,481,192,72,0,0,0,0,0
535452100,70.0,7560,0.0,504,0,525,1029,1339,0,0,1339,294,0,0,0,0,0,0,0
903458010,60.0,7200,0.0,343,0,641,984,984,0,0,984,308,0,0,164,0,0,0,0
528294050,64.0,7848,0.0,0,0,384,384,774,656,0,1430,410,0,0,0,0,0,0,0
904351040,64.0,6449,0.0,73,0,634,707,942,942,0,1884,0,0,0,239,0,0,0,0
528292080,51.0,12104,0.0,0,0,1035,1035,1082,1240,0,2322,617,400,45,0,0,0,0,0
903231240,51.0,6120,0.0,489,0,279,768,1015,0,0,1015,450,0,0,112,0,120,0,620
903226150,50.0,6000,0.0,0,0,949,949,949,0,0,949,370,0,0,48,0,0,0,0
528218090,63.0,10928,0.0,0,0,728,728,728,728,0,1456,390,100,0,0,0,0,0,0
909251080,66.0,8969,0.0,379,0,265,644,672,644,0,1316,369,0,0,0,0,192,0,0
534276010,70.0,9100,0.0,521,174,169,864,864,0,0,864,624,0,0,0,0,0,0,0
535151040,73.0,8760,164.0,856,0,313,1169,1144,0,0,1144,286,257,0,0,0,0,0,0
528363070,73.0,10236,501.0,380,168,742,1290,1305,1189,0,2494,803,200,95,0,0,0,0,0
905107320,98.0,11616,328.0,438,0,234,672,672,714,0,1386,440,335,0,0,0,0,0,0
534427010,98.0,13260,144.0,1500,0,228,1728,1728,0,0,1728,0,0,0,0,0,0,0,0
528253020,55.0,7301,176.0,876,0,474,1350,1358,0,0,1358,484,192,26,0,0,0,0,0
528458050,72.0,8640,0.0,0,0,1372,1372,1372,0,0,1372,529,0,140,0,0,0,0,0
909428240,100.0,17500,420.0,784,435,91,1310,1906,0,0,1906,576,0,201,0,0,0,0,0
902125120,60.0,10800,0.0,0,0,641,641,1047,0,0,1047,273,0,0,0,0,0,0,450
908127040,73.0,10921,48.0,520,0,440,960,960,0,0,960,432,120,0,0,0,0,0,0
531453100,73.0,10274,141.0,331,0,345,676,698,702,0,1400,465,0,48,0,0,0,0,0
906476140,80.0,12000,0.0,853,0,535,1388,1388,0,0,1388,522,0,58,0,0,0,0,0
905104090,99.0,7094,0.0,180,374,340,894,894,0,0,894,384,0,0,0,0,0,0,0
533125140,105.0,11025,568.0,520,0,1328,1848,1827,959,0,2786,636,294,49,0,0,0,0,0
902110120,56.0,7745,0.0,0,0,938,938,1084,867,0,1951,576,0,6,28,0,0,0,0
533217060,24.0,2160,216.0,600,0,72,672,684,720,0,1404,462,20,0,0,0,0,0,0
916403290,44.0,13758,117.0,902,0,254,1156,1187,530,0,1717,400,168,36,0,0,0,0,0
528477010,100.0,13162,0.0,1836,0,200,2036,2036,604,0,2640,792,0,265,0,0,0,0,0
534428100,100.0,11332,0.0,528,0,590,1118,1118,0,0,1118,264,290,0,0,0,0,0,0
923229110,55.0,12640,0.0,936,396,396,1728,1728,0,0,1728,574,40,0,0,0,0,0,0
534202160,80.0,9600,172.0,698,0,534,1232,1232,0,0,1232,490,0,224,0,0,0,0,0
528228460,43.0,3182,11.0,16,0,1129,1145,1145,0,0,1145,397,100,16,0,0,0,0,0
535176050,80.0,11600,175.0,565,0,818,1383,1383,0,0,1383,292,0,45,0,0,0,0,0
907275140,80.0,12782,164.0,1360,0,462,1822,1828,0,0,1828,523,194,144,0,0,0,0,0
528186170,48.0,6240,196.0,24,0,1318,1342,1342,0,0,1342,550,0,35,0,0,0,0,0
909281030,79.0,7801,88.0,500,0,591,1091,1091,0,0,1091,344,66,105,0,0,221,0,0
532351050,70.0,9100,0.0,53,799,132,984,984,0,0,984,384,145,56,0,0,0,0,400
527254070,69.0,11302,238.0,1422,0,392,1814,1826,0,0,1826,758,180,75,0,0,120,0,0
535301060,60.0,11556,0.0,408,0,456,864,1154,0,0,1154,336,63,0,0,0,0,0,0
907202140,69.0,9920,0.0,523,0,448,971,971,0,0,971,300,0,0,0,0,0,0,0
534202020,69.0,9759,0.0,799,0,252,1051,1051,0,0,1051,264,182,88,0,0,0,0,0
534250400,80.0,9600,252.0,698,0,467,1165,1165,896,0,2061,498,0,77,0,0,196,0,0
528188060,36.0,2268,106.0,567,0,197,764,764,862,0,1626,474,0,27,0,0,0,0,0
905325030,36.0,23595,0.0,1258,0,74,1332,1332,192,0,1524,586,268,0,0,0,0,0,0
908102160,75.0,9825,162.0,936,0,0,936,936,0,0,936,384,405,0,0,0,0,0,450
907131060,57.0,10021,0.0,539,0,96,635,646,662,0,1308,497,142,54,0,0,0,0,0
534127260,130.0,11700,196.0,910,0,385,1295,1295,0,0,1295,528,0,194,0,0,200,0,0
535125010,130.0,19900,287.0,912,0,1035,1947,2207,0,0,2207,576,301,0,0,0,0,0,0
528456180,72.0,8640,0.0,822,0,78,900,932,920,0,1852,644,168,108,0,0,0,0,0
909451040,24.0,1733,0.0,0,0,516,516,516,516,0,1032,452,279,0,0,0,0,0,0
907201230,42.0,10385,123.0,595,400,0,995,1282,0,0,1282,672,386,0,0,0,0,0,0
923203110,32.0,4500,320.0,866,0,338,1204,1204,0,0,1204,412,0,247,0,0,0,0,0
534252240,32.0,9790,0.0,251,630,491,1372,1342,0,0,1342,457,0,0,0,0,197,0,0
535403200,60.0,7332,207.0,414,0,450,864,864,0,0,864,288,168,0,0,0,0,0,0
535301010,60.0,7032,0.0,943,0,0,943,943,0,0,943,600,42,0,0,0,0,0,0
905427050,66.0,21780,0.0,0,0,1163,1163,1163,511,0,1674,396,72,36,0,0,144,0,0
902125080,60.0,5790,0.0,0,0,840,840,840,765,0,1605,379,0,0,202,0,0,0,0
527132090,61.0,7380,0.0,341,0,1077,1418,1478,0,0,1478,495,168,43,0,0,0,0,0
923226270,21.0,1526,0.0,515,0,115,630,630,0,0,630,286,0,0,0,0,0,0,0
907192150,72.0,11317,101.0,0,0,840,840,840,828,0,1668,500,144,68,0,0,0,0,0
923275140,72.0,8780,0.0,625,0,208,833,833,0,0,833,0,0,0,0,0,0,0,0
528142110,90.0,12378,0.0,1274,0,622,1896,1944,0,0,1944,708,208,175,0,0,0,0,0
527427090,34.0,4058,182.0,584,139,0,723,767,0,0,767,367,120,40,0,0,0,0,0
527451110,24.0,2368,312.0,765,0,0,765,765,600,0,1365,440,0,36,0,0,0,0,0
534400290,85.0,9350,217.0,310,512,491,1313,1313,0,0,1313,610,172,28,0,0,121,0,0
906226130,64.0,7040,216.0,1094,0,0,1094,1229,0,0,1229,672,120,0,0,0,0,0,0
907260030,70.0,8749,106.23603192702394,0,0,840,840,840,885,0,1725,550,0,48,0,0,0,0,0
916460020,70.0,7777,203.0,0,0,1491,1491,1491,0,0,1491,571,0,35,0,0,0,0,0
527182170,70.0,5062,0.0,828,182,180,1190,1190,900,0,2090,577,219,0,0,0,0,0,0
923276250,70.0,7700,0.0,0,0,1216,1216,1216,1216,0,2432,616,200,0,0,0,0,0,600
906426090,70.0,36500,621.0,812,0,812,1624,1582,0,0,1582,390,168,198,0,0,0,0,0
528231010,182.0,14572,0.0,1300,0,230,1530,1530,0,0,1530,630,144,36,0,0,0,0,0
527254020,80.0,11844,464.0,0,0,2046,2046,2046,0,0,2046,834,322,82,0,0,0,0,0
907401050,70.0,8810,0.0,1000,0,390,1390,1390,0,0,1390,545,0,68,0,0,0,0,0
527377110,80.0,8000,0.0,931,153,0,1084,1084,793,0,1877,488,0,96,0,0,0,0,0
535126140,90.0,14670,410.0,575,0,529,1104,1104,884,0,1988,480,0,230,0,0,0,0,0
904100040,55.0,8250,0.0,250,492,210,952,1211,0,0,1211,322,0,63,0,0,0,0,0
527425140,60.0,9000,0.0,616,0,248,864,864,0,0,864,528,0,0,0,0,0,0,0
535327160,70.0,8400,0.0,793,0,130,923,925,0,0,925,390,81,0,0,0,0,0,0
